---config@码表分类=主码-4
---config@码表别名=CJKExt_C
𪟋	afjh
𪟥	agal
𪟬	aed
𪟭	aanh
𪟮	aqnr
𪟯	ajfd
𪟰	awtk
𪟱	aosd
𪟲	aujm
𪠯	akkc
𪡻	ahjd
𪤀	ahnf
𪤱	akfu
𪥎	agdu
𪦑	ahnv
𪧂	ahnb
𪩤	angj
𪩥	anyk
𪩦	anss
𪩩	anwp
𪩪	anww
𪪫	akfl
𪭅	afan
𪭉	agf
𪭊	alv
𪭌	alf
𪭍	awat
𪭎	atld
𪭐	aebd
𪭑	amhh
𪯗	aetv
𪯘	aqat
𪯝	aetg
𪯭	adjf
𪯵	agyn
𪱞	afed
𪲣	afsh
𪴮	ajqw
𪴰	adkw
𪴳	awww
𪵒	ajmc
𪷂	ajdi
𪺧	ahtw
𪺨	ahtf
𪺶	awnh
𫄿	aqkm
𫅷	awsx
𫇅	ahnr
𫇆	ahnh
𫇇	ahnt
𫇈	ahnf
𫇉	ahnm
𫇦	apb
𫇧	awnb
𫇨	akj
𫇩	agf
𫇪	amqu
𫇫	awqu
𫇬	aqqu
𫇭	ayly
𫇮	aant
𫇯	akgn
𫇰	ahjf
𫇱	awbf
𫇲	awff
𫇳	awhf
𫇴	aqvf
𫇵	aveb
𫇶	agmf
𫇷	aftn
𫇸	atj
𫇹	awxw
𫇺	ayff
𫇻	aibb
𫇼	aimy
𫇽	apeu
𫇾	aiff
𫇿	agki
𫈀	akqw
𫈁	alfj
𫈂	amtu
𫈃	aqtg
𫈄	awnw
𫈅	awwk
𫈆	awlk
𫈇	arxb
𫈈	awdk
𫈉	aujf
𫈊	aiyb
𫈋	ayxx
𫈌	apfw
𫈍	anhu
𫈎	acal
𫈏	acej
𫈐	afuf
𫈑	agyu
𫈒	ageu
𫈓	agah
𫈔	ajqf
𫈕	akib
𫈖	aqju
𫈗	atkf
𫈘	awyv
𫈙	atgy
𫈚	aytu
𫈛	apmf
𫈜	aimf
𫈝	annu
𫈞	aiyx
𫈟	abai
𫈠	alkf
𫈡	agmp
𫈢	adjb
𫈣	albb
𫈤	agvi
𫈥	assk
𫈦	amwt
𫈧	ajmy
𫈨	alwj
𫈩	ajfb
𫈪	awxi
𫈫	atdw
𫈬	apwn
𫈭	aiud
𫈮	ayeu
𫈯	augy
𫈰	aiwk
𫈱	ayde
𫈲	ainf
𫈳	aiii
𫈴	awga
𫈵	axqc
𫈶	agme
𫈷	asmk
𫈸	adun
𫈹	adlj
𫈺	asyw
𫈻	adfy
𫈼	aldt
𫈽	alfo
𫈾	awhh
𫈿	awnc
𫉀	arno
𫉁	aepc
𫉂	apjs
𫉃	aitj
𫉄	ayfj
𫉅	avkn
𫉆	alle
𫉇	axic
𫉈	agkr
𫉉	aalw
𫉊	afwy
𫉋	agtj
𫉌	adfn
𫉍	afwt
𫉎	asgk
𫉏	aakc
𫉑	aufj
𫉒	aiph
𫉔	awnh
𫉕	awsk
𫉖	aefb
𫉗	aifu
𫉘	ayvh
𫉙	aiqo
𫉚	ayyn
𫉛	abtv
𫉜	axfm
𫉝	aggn
𫉞	akkf
𫉟	aqqf
𫉠	awfb
𫉡	aeyf
𫉢	arrk
𫉣	aide
𫉤	abjr
𫉥	afwl
𫉦	agqt
𫉧	ajto
𫉨	ajmc
𫉩	akwo
𫉪	atxt
𫉫	awfh
𫉬	aqtc
𫉭	aufq
𫉮	aujw
𫉯	aiwc
𫉰	aigl
𫉱	aoge
𫉲	apff
𫉳	ackc
𫉴	annj
𫉵	afce
𫉷	afuf
𫉸	askw
𫉹	asrf
𫉺	aahi
𫉻	ajsb
𫉼	aldh
𫊀	apwg
𫊁	ainf
𫊂	ayyf
𫊄	axil
𫊅	ajmi
𫊆	atdc
𫊇	atfk
𫊈	awfh
𫊉	aihh
𫊊	aode
𫊋	aiws
𫊌	aglo
𫊍	aann
𫊎	awnf
𫊏	atlf
𫊐	adfq
𫊑	adtl
𫊒	aqof
𫊓	aiao
𫊔	afto
𫊕	atft
𫊖	aeyj
𫊗	aahl
𫊘	ajah
𫊙	aqgf
𫊚	arii
𫊛	akhb
𫊜	allg
𫎡	ahnm
𫐟	api
𫐬	agfp
𫑛	antb
𫑝	atdb
𫑠	aabh
𫑧	akkb
𫔙	auf
𫖅	afdx
𫖆	akfw
𫖇	afwf
𫖉	afae
𫖊	afsj
𫖋	afnc
𫖷	ansm
𫛰	adwg
𫜱	amhd
𪞷	bmah
𪞹	bmvn
𪞺	bmen
𪠱	bcfy
𪣿	btaf
𪤝	bjgf
𪥡	bued
𪦶	bfcy
𪦷	bat
𪦸	buy
𪦹	byy
𪦺	brg
𪦼	brqy
𪦾	bnjw
𪦿	bwge
𪧀	bmmv
𪧁	blfh
𪧄	brcc
𪫽	binu
𪱝	bief
𪳎	bosu
𫆀	bbh
𫆁	bqwy
𫆂	bwgg
𫆄	bdgn
𫆅	bktf
𫆆	bctd
𫆇	besy
𫆊	bamw
𫆋	bgkh
𫆌	buwl
𫆍	bgve
𫆐	bkkf
𫆑	bwgj
𫆒	bpqn
𫆓	bgke
𫏵	bilj
𫔺	bdy
𫔻	byy
𫔼	bmg
𫔽	bcfg
𫔾	bbg
𫔿	bjsh
𫕀	budy
𫕁	bgkg
𫕂	bpqv
𫕂	bpwv
𫕃	bcbb
𫕄	bhwy
𫕅	byjg
𫕆	bgka
𫕇	bgxf
𫕈	bjqn
𫕉	befc
𫕊	bexc
𫕋	bemf
𫕌	brna
𫕍	bpgg
𫕎	bwcn
𫕏	btnf
𫕐	bdqq
𫕑	bqgl
𫕒	bumd
𫕓	bcck
𫕔	bdui
𫕕	bafk
𫕖	bskn
𫕗	byti
𫕘	bxgg
𫛉	bbwo
𪜝	cbaw
𪠂	cvcb
𪠟	cdeq
𪠠	ctdw
𪠡	cdew
𪠥	cef
𪠰	cccj
𪣽	cffb
𪤘	cfas
𪦠	ccvf
𪩬	cqhh
𪩭	csww
𪩮	cfwt
𪩱	cugi
𪪴	cfha
𪱜	ckeg
𪳫	cccm
𪵎	cbmc
𪵨	ciu
𪽡	ctol
𪿆	cbtr
𪿇	cbte
𫊫	cuju
𫊲	cdju
𫌵	ccyf
𫐊	cdlj
𫖭	ckdm
𫘅	ccyy
𫘆	cfwy
𫘇	caqn
𫘈	cmcy
𫘉	coy
𫘊	csg
𫘋	cgmg
𫘌	chaq
𫘍	ckmk
𫘏	cdmd
𫘐	ctgf
𫘑	cugd
𫘒	cgef
𫘓	clwt
𫘔	cwqj
𫘕	cuvo
𫘗	casw
𫘙	cmgo
𫘚	colw
𫘛	cfh
𫘜	cyy
𫘝	cnwy
𫘞	ctbn
𫘟	chcy
𫘠	cgcf
𫘡	ciqn
𫘢	cskg
𫘣	cjfh
𫘤	cctd
𫘥	cjxx
𫘦	cqrm
𫘧	cviy
𫘨	cjgh
𫘩	crgg
𫘪	cdri
𫘫	cjpv
𫘬	cexd
𫘭	cdqq
𫘮	cumd
𫘯	culj
𫘰	cylg
𫘱	cmwk
𫛋	ckno
𪜇	dnww
𪜘	dhcn
𪞟	dwuu
𪟁	dcjh
𪟃	ddjh
𪟉	dufj
𪟊	degv
𪠃	dcd
𪠄	djnv
𪠅	dfkd
𪠆	duak
𪠇	dfoi
𪠈	dkkn
𪠉	dhqh
𪠊	djdi
𪠋	dfhd
𪠌	dxdm
𪠍	ddei
𪠎	dwcn
𪠏	ddhc
𪠐	dwfg
𪠑	dgef
𪠒	deut
𪠓	damw
𪠔	drxc
𪠕	dnwy
𪠖	dogy
𪠘	dqeh
𪠙	duen
𪠚	dttl
𪠛	dkkt
𪠦	dfcy
𪡐	dklk
𪡜	dwkq
𪡪	dfek
𪡬	djtk
𪢏	dfeb
𪣗	dfef
𪤬	dddf
𪥁	dnb
𪥂	dvn
𪥅	dat
𪥆	dwcu
𪥈	dguh
𪥋	dfiu
𪥍	dgjn
𪥏	dywy
𪥐	dwyh
𪥑	dfie
𪥓	dgmf
𪥕	dnbm
𪥚	dufq
𪥜	dkka
𪨈	dnkj
𪨯	dnnm
𪩣	daf
𪩫	dwnb
𪪈	djdh
𪫷	dtfn
𪬇	dhdt
𪭏	davt
𪭔	depa
𪯯	dhwf
𪱤	dett
𪱰	deyf
𪴪	dfqw
𪵈	dfnc
𪵪	diu
𪶰	deiu
𪼵	duxy
𪽂	dtcg
𪾊	dnlf
𪿑	dfqn
𪿒	dhbh
𪿓	dxgg
𪿔	daqn
𪿕	dqkg
𪿖	dyxy
𪿗	dnxn
𪿘	dckg
𪿙	ddoy
𪿚	dffy
𪿛	djy
𪿜	dpqn
𪿜	dpwn
𪿞	ddtf
𪿟	ddfe
𪿠	dkeg
𪿡	dpqf
𪿡	dpwf
𪿢	duh
𪿣	dvfb
𪿤	ddqn
𪿥	dsty
𪿦	dgey
𪿧	driy
𪿨	ddjd
𪿩	dndg
𪿪	drdf
𪿫	dcuq
𪿬	ddun
𪿭	dpey
𪿮	dpwk
𪿯	depy
𪿰	dwfw
𪿱	dtel
𪿲	dpqm
𪿲	dpwm
𪿳	dyfq
𪿴	dydg
𪿵	dfwl
𪿶	ddhi
𪿷	dpnh
𪿸	dddh
𪿹	dhby
𪿺	dtuh
𪿻	dahu
𪿼	dbci
𪿽	dria
𪿾	datl
𪿿	dedt
𫀄	dfit
𫀜	dwti
𫀳	dqgt
𫅰	djdn
𫆕	dfih
𫋒	dcjj
𫋫	dwtl
𫏔	dmjh
𫐢	dpd
𫐦	dqpv
𫑖	djdp
𫑥	dfeb
𫑮	djfb
𫔖	dpey
𫔗	dgdn
𫔬	dnub
𫖀	dmjs
𫖁	dmjq
𫖃	dmjm
𫖧	dmji
𫖬	dmwe
𫖸	drim
𫖹	dhim
𫗌	dfau
𫘸	denb
𫘹	deqy
𫘺	devf
𫘻	depm
𫘼	demf
𫘽	dewc
𫘾	dede
𫘿	devk
𫙀	defj
𫙁	deqq
𫙂	deov
𫙃	dejq
𫚯	dmwo
𫛍	dwfo
𫛟	dxqg
𫛦	dfng
𫛷	deqg
𫜩	dhvb
𫜲	dedx
𫜷	dtfb
𪜌	ejd
𪜛	ebnh
𪣪	etaf
𪥣	exdq
𪨁	ebiy
𪱙	ecy
𪱚	ehg
𪱠	egoc
𪱡	ewfi
𪱢	ethj
𪱣	emun
𪱥	efam
𪱦	ergg
𪱧	eypq
𪱨	eujn
𪱩	eybc
𪱪	eudo
𪱬	eief
𪱭	eyoe
𪹗	evoy
𪺍	evf
𪺏	eeu
𪺒	ehtu
𪺓	evhs
𪺔	epqe
𪺕	exxx
𪺗	evhq
𪺙	exty
𪺚	eqoo
𪽋	elf
𪾔	edml
𪾕	eudl
𫂲	eou
𫆖	efyy
𫆗	eqbh
𫆘	efyy
𫆚	emg
𫆛	eway
𫆝	euft
𫆞	evag
𫆟	eipl
𫆠	eudj
𫆣	eldg
𫆤	eqg
𫆦	eith
𫆧	etvh
𫆨	euej
𫆩	ekkp
𫆪	elqt
𫆮	ebti
𫆯	egwt
𫆱	esrc
𫆲	eafb
𫆳	ejlc
𫆵	egjn
𫆷	eyfx
𫆹	eadi
𫆻	exjq
𫆼	eauy
𫆾	eafy
𫇀	edth
𫇁	etgq
𫇃	egmx
𫌎	ewke
𫎅	egf
𫎆	ewwy
𫎈	eedy
𫎊	eeay
𫎋	eede
𫎌	eeov
𫎍	eedn
𫐭	evhp
𫐳	ehfd
𫐴	ewyp
𫐾	egip
𫑞	egnb
𫑲	elvb
𫖠	ehdm
𫖨	ejdm
𫛔	etno
𫛳	ebcg
𫜶	eybt
𪜀	fnv
𪜕	ftjn
𪜞	fcdt
𪞉	fkaw
𪞱	fpmb
𪞾	fwjh
𪟈	ftjj
𪟌	fkuj
𪟴	fkfn
𪟵	fjvy
𪟹	fpxc
𪟺	fjwj
𪟾	fihi
𪠝	fcnx
𪠢	fcyw
𪡹	fnmk
𪢢	fkug
𪢣	fkue
𪢱	fhu
𪢲	fcy
𪢳	fcnb
𪢴	ffg
𪢵	fmyy
𪢷	fynn
𪢸	ffqn
𪢹	fdmn
𪢺	fhcy
𪢻	feg
𪢼	fwxn
𪢽	ftfh
𪢿	fiy
𪣀	fcn
𪣁	fcqn
𪣂	fbnn
𪣃	fgmw
𪣄	fdfj
𪣅	fann
𪣆	faiy
𪣇	ftpy
𪣈	fmkg
𪣉	fyni
𪣊	fntt
𪣋	fdhb
𪣌	fbg
𪣍	fjen
𪣎	friy
𪣏	fyth
𪣐	fyfg
𪣑	fpey
𪣒	fplh
𪣓	fnta
𪣔	fgkg
𪣕	fdqn
𪣘	fknd
𪣙	fjug
𪣚	fjvg
𪣛	ftjh
𪣜	ften
𪣝	fran
𪣞	fpqa
𪣟	fpqf
𪣠	fykg
𪣢	fiyy
𪣣	fvtk
𪣤	fajg
𪣥	fgah
𪣦	fjeg
𪣧	fjjg
𪣨	flfh
𪣩	fheg
𪣫	fynj
𪣬	fpnn
𪣮	finx
𪣯	fpeg
𪣰	flah
𪣱	fuqh
𪣲	falg
𪣳	fdmf
𪣴	fght
𪣵	fuxe
𪣷	fqmd
𪣹	fyps
𪣺	fnwk
𪣻	fovg
𪣼	fyod
𪣾	fcex
𪤁	fgkf
𪤂	fhlg
𪤃	fjpv
𪤄	flfc
𪤅	fipq
𪤆	frnn
𪤇	fwgk
𪤉	fudi
𪤋	fybc
𪤌	fccs
𪤍	fnae
𪤎	flpy
𪤏	fadf
𪤐	ffxh
𪤑	flag
𪤒	fwgl
𪤓	ftxt
𪤔	ftny
𪤔	fyny
𪤕	fydg
𪤖	fnhf
𪤗	fnwe
𪤙	ffoy
𪤚	fbud
𪤛	ftfn
𪤞	fnfp
𪤟	fmuf
𪤠	fflg
𪤡	fmau
𪤢	fkks
𪤣	fwgn
𪤤	fpyi
𪤥	fujn
𪤦	fgei
𪤧	fwfw
𪤨	fthj
𪤩	fqmt
𪤪	fyjg
𪤫	fobc
𪤭	fhbh
𪤮	fpdi
𪤯	fyjd
𪤰	ffss
𪤲	fnqh
𪤳	fnkf
𪤴	fpgl
𪤽	fwtq
𪥃	fwsj
𪥊	fidy
𪥟	ftgd
𪦵	fhwv
𪧡	fhnf
𪧸	ffwf
𪪁	ffjh
𪪂	fjfh
𪪉	fuft
𪪲	fgpd
𪪵	fiya
𪭁	fpgn
𪭋	fabd
𪭒	faeb
𪮣	fhfr
𪯆	fcff
𪯈	fwty
𪯎	fuft
𪰛	ffjg
𪱶	fjsi
𪱼	fiwn
𪲅	figh
𪲭	fqyq
𪳭	fwfi
𪵋	ftbc
𪵑	fnmj
𪵣	fcrn
𪸓	fqou
𪸦	ftxo
𪾓	fdnl
𫀁	fivg
𫀂	ftyi
𫀆	fiqn
𫀏	fipq
𫀙	fict
𫀟	fint
𫀤	fikt
𫅢	fnf
𫅣	fqnd
𫅳	ftxx
𫅴	ftxc
𫅵	ftxt
𫅶	ftxy
𫅶	ftxj
𫅸	ftxo
𫆢	fwte
𫇔	fkmn
𫇗	fkuo
𫇤	fclc
𫌡	fwfq
𫌤	fnmq
𫎁	fjwk
𫎜	fitm
𫎭	foca
𫎮	fogf
𫎯	foaj
𫎰	foxl
𫎱	fhdl
𫎲	fhfi
𫎳	fhxf
𫎴	fhmk
𫎵	fhdq
𫎶	fhai
𫎷	fhbi
𫎸	fhlr
𫎹	fhjf
𫎺	fhce
𫎻	fhjg
𫎼	fhnv
𫎽	fhfl
𫎾	fhsb
𫎿	fhdq
𫏼	fwfl
𫐥	ftxp
𫐨	fopi
𫐫	fqqp
𫐫	fwqp
𫑄	fgpd
𫑆	fcyp
𫑘	fnyb
𫑪	flbh
𫓖	fkuq
𫕛	fkwy
𫕝	fbj
𫕞	fff
𫕟	fef
𫕠	fcb
𫕡	fuxb
𫕢	fxgu
𫕤	fwtf
𫕥	fkmu
𫕦	fiyu
𫕧	fawv
𫕨	fcde
𫕩	fjaf
𫕪	figj
𫕫	frde
𫕬	fafl
𫕭	fihj
𫕮	fafb
𫕯	feto
𫕰	fedh
𫕱	fwys
𫕲	fwgp
𫕳	fafg
𫕴	fujn
𫕵	filf
𫕶	fnkf
𫕷	fidy
𫖐	fash
𫖑	fnhn
𫖒	fnhf
𫖓	fnhf
𫖔	fnhe
𫖕	fnhf
𫖖	fnhu
𫖡	fpgm
𫗍	ftwe
𫙌	ffhc
𫛑	fkko
𫛛	fcqg
𫛿	fotg
𫜕	fpgt
𫜰	fmub
𪜁	gbj
𪜂	gvyu
𪜃	gkvn
𪜄	gisk
𪜆	gxxh
𪜑	gsnb
𪞿	gbnj
𪟆	gcej
𪟝	gmln
𪟤	gall
𪠜	gcmh
𪡅	gkkd
𪤶	ghft
𪥇	gmwd
𪥉	gdcb
𪧽	giff
𪨇	gqkm
𪩲	gmht
𪪄	guhn
𪪅	guhn
𪪆	guhn
𪪇	guhy
𪪩	gayo
𪪬	gfpk
𪪭	guhp
𪪯	gvap
𪫈	gkhe
𪫊	gaeh
𪫵	gany
𪬈	gkin
𪬯	gkin
𪬿	gmhn
𪯋	guwc
𪯍	gjqt
𪯑	gxit
𪯓	gmat
𪯥	ggyu
𪱟	gjge
𪲑	gbsu
𪲕	gmic
𪲠	gvws
𪲥	gkic
𪲬	gmho
𪲸	gmii
𪳈	gams
𪴹	ghic
𪴻	gigk
𪴽	gigt
𪵀	gqqn
𪵁	gqbc
𪵂	gqyb
𪵂	gqhb
𪵃	gqvq
𪵄	gqhq
𪵅	gqwa
𪵆	gqfw
𪵇	gqgm
𪵐	gehc
𪺽	gody
𪻍	gcy
𪻎	gqfg
𪻏	geyy
𪻐	gwwy
𪻑	gymn
𪻒	gny
𪻓	goy
𪻔	gpqn
𪻕	gdg
𪻖	gwfn
𪻗	gdfg
𪻘	ggjg
𪻙	gaag
𪻚	gaqy
𪻛	gmgk
𪻜	gwsy
𪻝	gpgf
𪻞	gynw
𪻟	gndh
𪻠	ggah
𪻡	ggku
𪻢	grrh
𪻣	gmqk
𪻤	grgw
𪻥	gybh
𪻦	gdfi
𪻧	gfqf
𪻨	gfnd
𪻩	gsrh
𪻪	gjeg
𪻫	gmun
𪻬	grgm
𪻭	gpgg
𪻮	gogg
𪻯	gyty
𪻰	gcqt
𪻱	gbib
𪻲	gxfm
𪻳	gfmf
𪻴	ggwe
𪻵	gdjf
𪻶	gdjb
𪻷	gadk
𪻸	gask
𪻺	gkhm
𪻻	gith
𪻼	grsy
𪻽	gptk
𪻾	gyde
𪻿	gyac
𪼀	guph
𪼁	gyod
𪼂	guty
𪼃	gdwi
𪼄	gfke
𪼅	gepy
𪼆	gdri
𪼇	gmth
𪼊	gtfh
𪼋	gttn
𪼌	gwyc
𪼍	gpqg
𪼍	gpwg
𪼎	gugc
𪼏	gccs
𪼐	gdqq
𪼑	gahf
𪼒	gapq
𪼓	glag
𪼔	gwge
𪼕	gytd
𪼖	gpvw
𪼗	gfyy
𪼘	gapg
𪼙	gugg
𪼚	gjqq
𪼛	gwys
𪼜	gwgn
𪼝	gyin
𪼞	guaj
𪼟	gnih
𪼠	gwxc
𪼡	gglg
𪼢	glff
𪼣	gtmd
𪼤	gqdy
𪼥	gyuo
𪼦	gujn
𪼧	ggjk
𪼨	gpxe
𪼩	gddj
𪼪	gted
𪼫	gulb
𪼬	gfss
𪼭	gpdn
𪼮	gple
𪼯	gugt
𪼰	gwfr
𪼱	gygm
𪼲	gipo
𪼶	gnyn
𪼷	gnyg
𪼸	gnyo
𪼹	gnyg
𪼻	gnyw
𪼼	gnyh
𪼿	gnyv
𫀀	gcfi
𫁮	gwmu
[𫅞]	gvck
𫆰	gqtw
𫇎	gcfi
𫇏	gcfw
𫇐	gcfg
𫇑	gcft
𫉐	gjgy
𫉶	gjgl
𫉽	gjgp
𫉾	gjgb
𫉿	gjgi
𫊃	gjgk
𫋊	gkmj
𫌟	gaeq
𫌫	gliq
𫎄	gkus
𫎣	gcly
𫐁	gjhl
𫐣	gmwp
𫐿	gkip
𫑅	gkip
𫑋	gkip
𫑐	gkip
𫑒	gkip
𫑚	ghnb
𫑯	gvcf
𫑱	gvce
𫕸	geqh
𫕹	getg
𫕺	geuf
𫕻	gege
𫕼	geuq
𫖌	gkah
𫖴	gmdm
𫙄	gkmh
𫙅	gkme
𫚓	gqjg
𫛁	gaho
𫛚	gaqg
𫛜	giqg
𫛥	guwg
𫛶	gkig
𫜑	gtdh
𫜒	gtpx
𫜓	gtke
𫜔	gtrf
𫜘	gmhw
𪜈	hgan
𪟂	hkvn
𪟷	hjch
𪟽	hbj
𪟿	hjhy
𪠀	hpgf
𪥤	hvf
𪫩	hnu
𪬊	hqrn
𪭓	hlat
𪳐	hhsu
𪴶	hgjg
𪴷	hceh
𪴸	hfnt
𪴼	hdat
𪾆	hcqh
𪾇	hcty
𪾈	hcsv
𪾉	hcbb
𪾏	hlnl
𪾟	hgng
𪾠	hqyy
𪾡	hdnn
𪾢	hmqn
𪾣	hpgg
𪾤	hdnt
𪾥	hkgn
𪾦	hhnt
𪾧	hwgc
𪾨	hkfn
𪾩	hpgf
𪾪	huqw
𪾫	hegl
𪾬	htdn
𪾭	hssy
𪾮	hetf
𪾯	hrqw
𪾰	hyty
𪾱	hith
𪾲	hujg
𪾳	hnhh
𪾴	hnoy
𪾵	hgxi
𪾶	htff
𪾷	hwye
𪾸	hprw
𪾹	haqh
𪾼	hfpu
𪾽	huyy
𪾾	htwk
𪾿	huoj
𪿀	hpjy
𪿄	htun
𪿅	hywo
𫁅	hmtc
𫆶	hjye
𫊝	hakd
𫊞	havd
𫊟	hatf
𫊠	hamh
𫊡	hath
𫊢	hayj
𫊣	haqo
𫌜	hqvd
𫌝	hqkq
𫌢	hqff
𫌣	hqas
𫌧	hqym
𫍐	hidy
𫎎	hmhh
𫐞	hypk
𫖣	hmdm
𫚖	hxqg
𫛄	hiwo
𫛧	hiqg
𫛱	hjqg
𫛹	hitg
𫜇	hlqo
𫜇	hloo
𫜉	hlqy
𫜉	hloy
𫜊	hlql
𫜠	hndb
𫜡	hndy
𫜥	hbmm
𫜦	hbgy
𫜧	hbps
𫜨	hwbc
𫜪	hwbq
𫜫	hwby
𫜬	hwbj
𫜭	hwbr
𫜮	hwbe
𫜯	hwbk
𪜚	istn
𪞀	iqqh
𪞃	iqjg
𪞆	iqho
𪟛	ivyl
𪟜	iitl
𪡌	iqwk
𪡤	irek
𪣡	itdf
𪣭	ihcf
𪤊	iyvf
𪨀	ibmh
𪨃	iryf
𪨄	itwm
𪨅	itdy
𪨆	itoe
𪨤	imj
𪫆	ivg
𪫚	ifch
𪬬	igen
𪭕	iada
𪳷	ijgs
𪳼	ifti
𪵩	ighy
𪵫	iay
𪵬	itmn
𪵭	idgn
𪵮	irj
𪵯	iet
𪵰	ixhh
𪵱	iddn
𪵲	immg
𪵳	itdy
𪵴	itmh
𪵶	inln
𪵷	iafg
𪵸	ifbn
𪵹	iabh
𪵺	ihqy
𪵻	itlw
𪵼	iqcb
𪵽	iccc
𪵾	iskg
𪶀	illn
𪶁	imgg
𪶂	ihqb
𪶃	iklj
𪶄	ijfy
𪶅	iwfi
𪶆	iqto
𪶇	itdf
𪶈	ionn
𪶉	ipql
𪶊	iycf
𪶊	iyfy
𪶊	ihcf
𪶋	ivit
𪶌	igcj
𪶍	igdh
𪶎	irvk
𪶏	ifch
𪶐	imdf
𪶑	ilnt
𪶒	ilqy
𪶓	itmd
𪶔	iwff
𪶕	iobh
𪶖	iblg
𪶗	ifaf
𪶘	ibbh
𪶙	idff
𪶚	ifin
𪶜	irua
𪶝	igck
𪶞	imhd
𪶟	imcw
𪶠	iwct
𪶡	iwgn
𪶢	iwwt
𪶣	itla
𪶤	iwuy
𪶥	ingg
𪶦	iyey
𪶧	iyob
𪶨	ivcn
𪶩	ickn
𪶪	isgn
𪶫	idwy
𪶬	iadd
𪶭	igqo
𪶮	igon
𪶯	isdj
𪶱	imuh
𪶲	iald
𪶳	iqku
𪶴	iewj
𪶵	itrw
𪶶	iywf
𪶷	ipqq
𪶷	ipwq
𪶸	iyxi
𪶹	iytp
𪶺	iyoy
𪶻	iuqe
𪶼	iitk
𪶽	iccs
𪶾	ibgn
𪶿	ixtw
𪷀	ifir
𪷁	imtt
𪷃	ijcq
𪷄	iewq
𪷅	ipoo
𪷆	ipju
𪷇	iuev
𪷈	ixfm
𪷉	ixlg
𪷊	inug
𪷋	iftf
𪷌	idmo
𪷍	igeq
𪷎	iamt
𪷏	idgf
𪷐	iahy
𪷑	ijgf
𪷒	iaqm
𪷓	ihal
𪷔	imcq
𪷕	idjy
𪷖	iqdo
𪷗	ierf
𪷘	irmr
𪷙	iuqg
𪷚	ipwh
𪷛	ipgl
𪷜	ixii
𪷝	idyx
𪷞	iajl
𪷟	iope
𪷠	iaec
𪷡	ijkr
𪷢	ikgm
𪷤	iyli
𪷥	iuft
𪷦	iplp
𪷧	ivtd
𪷨	iahn
𪷩	idjs
𪷪	ifnm
𪷫	igei
𪷬	iahi
𪷭	iuff
𪷮	itfk
𪷯	iopi
𪷰	iujk
𪷱	ipfm
𪷲	iyaf
𪷳	ifih
𪷴	ifwo
𪷵	iabc
𪷶	iexc
𪷷	ipdi
𪷸	iynt
𪷺	iagn
𪷻	iqaa
𪷼	iqdk
𪷽	itfm
𪷾	iqxg
𪷿	ixfm
𪸀	ifnc
𪸁	iyac
𪸂	ioyc
𪸃	igeo
𪸄	iahh
𪸅	iqyi
𪸆	iqpk
𪸇	iynf
𪸈	ilff
𪸉	iqoi
𪸊	ievq
𪸋	ipfc
𪸌	iunu
𪾒	itul
𪾛	inhl
𪾻	iwyh
𪿝	iwdf
𫆏	ilrb
𫆙	ipef
𫆬	idfe
𫑜	iqbh
𫖯	iqdm
𫗚	ilre
𪝿	jbqb
𪟎	jtyj
𪥖	jand
𪧺	jghf
𪫉	jyje
𪰆	jag
𪰇	jqhh
𪰈	jfqn
𪰉	jfjh
𪰊	jhf
𪰋	jty
𪰌	jtfn
𪰍	jufh
𪰏	jskg
𪰐	jsgg
𪰑	jgyu
𪰒	jdg
𪰓	jgwf
𪰔	jmdu
𪰕	jtdy
𪰖	jtdu
𪰗	jntt
𪰘	jlkf
𪰙	jfkg
𪰚	jftx
𪰜	jaag
𪰝	jahj
𪰞	jafh
𪰟	jrhf
𪰠	jtah
𪰡	jwgg
𪰢	jyth
𪰣	jng
𪰤	jivg
𪰥	jgkg
𪰦	jwwf
𪰧	jpdc
𪰨	jnyn
𪰩	janx
𪰪	jsww
𪰫	jdfa
𪰬	jgtj
𪰭	jevh
𪰮	jrmj
𪰯	jghc
𪰰	jffh
𪰱	jght
𪰲	jdjb
𪰳	jdhd
𪰴	jwdc
𪰵	jcll
𪰶	jxjm
𪰷	jvfp
𪰸	jgxi
𪰹	jfjf
𪰺	jlqt
𪰻	jwgk
𪰼	jyvk
𪰽	jylh
𪰾	jghj
𪰿	jghb
𪱀	jlxi
𪱁	jqrf
𪱂	jqtj
𪱃	jtxt
𪱄	jpgw
𪱅	jifj
𪱆	jjfe
𪱇	jgjn
𪱈	jjjj
𪱉	jasw
𪱊	jtgk
𪱋	jugk
𪱌	jool
𪱍	jujn
𪱎	jtgj
𪱏	jqmt
𪱑	jdjf
𪱒	jyke
𪱓	joyc
𪱔	jwfq
𪱕	jbch
𪱖	jwyw
𪲹	jtys
𪳿	jsyc
𪴯	jogw
𪸣	jou
𪹕	jqjo
𪹶	jfto
𪻹	jtgy
𪾋	jclf
𫀝	jlfi
𫃆	jgho
𫊤	jxn
𫊥	jfg
𫊦	juhh
𫊧	javn
𫊨	jrnn
𫊩	jeyy
𫊪	jtay
𫊬	jmdy
𫊮	jhnt
𫊯	jtuh
𫊰	jqhy
𫊳	jgkq
𫊴	jrta
𫊵	jffy
𫊶	jiqn
𫊷	jqsy
𫊸	jtdj
𫊹	jwfc
𫊺	jxiy
𫊻	jvfy
𫊽	jkqj
𫊾	jtmt
𫊿	jwca
𫋀	jpsy
𫋁	juh
𫋂	jgvv
𫋃	jfy
𫋄	jrgb
𫋅	jryp
𫋆	jqg
𫋇	jqys
𫋈	jrny
𫋋	jgil
𫋌	jwam
𫋍	jptk
𫋎	juth
𫋏	jdfk
𫋐	jamy
𫋑	jgyg
𫋓	jawk
𫋔	jyxf
𫋕	jpey
𫋖	jgkj
𫋗	jiwy
𫋘	jxil
𫋙	jxcj
𫋚	jfkf
𫋛	jage
𫋜	jelf
𫋝	jwys
𫋞	jwgn
𫋟	jahl
𫋠	jmau
𫋢	jnup
𫋣	jadj
𫋤	jfnf
𫋥	jooe
𫋦	jfhc
𫋧	jyaw
𫋨	jygi
𫋩	jhqo
𫌷	jnyd
𫎥	jvdm
𫑀	jfhp
𫑦	jpvb
𫒁	jfgh
𫔸	jfhu
𫖢	jfim
𫖥	jgkm
𫙣	jfqo
𫛂	jqao
𫛸	jghg
𫜀	jdfg
𪜉	khgh
𪟣	kkml
𪠲	kcu
𪠳	klh
𪠴	kqty
𪠵	kwxn
𪠶	kwfg
𪠷	kqkf
𪠸	kqiy
𪠺	krvy
𪠻	kgcq
𪠼	kmww
𪠽	kivg
𪠾	ktey
𪠿	kthh
𪡀	ktdj
𪡁	kycq
𪡂	kcah
𪡃	knud
𪡄	kalh
𪡆	krwn
𪡇	kwqi
𪡈	kwrg
𪡉	ktkh
𪡊	keet
𪡋	kwgi
𪡎	klwc
𪡏	klpy
𪡒	kfuf
𪡓	kjxx
𪡔	klah
𪡕	kqrr
𪡖	kqld
𪡗	krqw
𪡙	kyvb
𪡚	kitg
𪡛	kusk
𪡝	kawn
𪡞	kkhm
𪡟	kwct
𪡠	kriy
𪡡	kqyg
𪡣	kpgm
𪡥	kiaw
𪡦	kuhb
𪡧	kusg
𪡨	knoy
𪡩	kmdo
𪡫	kfke
𪡭	ksgn
𪡮	kmfy
𪡯	kmun
𪡰	kkvb
𪡱	kdin
𪡴	kynn
𪡵	kike
𪡶	kpqy
𪡷	kbwt
𪡸	kruv
𪡺	kgom
𪡼	kkhd
𪡽	kjfh
𪡾	kttg
𪡿	kega
𪢀	ktlt
𪢁	kyja
𪢂	kugh
𪢃	kybt
𪢄	knug
𪢅	krnf
𪢆	kftp
𪢇	kssp
𪢉	ktmk
𪢊	ktli
𪢋	kwsm
𪢌	kugi
𪢍	kxfk
𪢎	kbkf
𪢐	kgkm
𪢑	ktwk
𪢒	kovt
𪢔	kyno
𪢕	kgqm
𪢖	ktqn
𪢗	kpnj
𪢘	kugi
𪢙	kgjh
𪢚	krjc
𪢛	kmeh
𪢜	kqgy
𪢝	ktfn
𪢟	kymd
𪢠	kaui
𪢤	ktdk
𪢥	kthp
𪢧	kbtn
𪥒	kqwd
𪫰	kknu
𪬩	kmln
𪯟	kkht
𪯡	khyu
𪯮	kylf
𪳓	keys
𪵉	kfmc
𪹬	kkao
𪼺	kman
𪾍	kqlf
𫏀	khfy
𫏁	khgu
𫏂	khty
𫏃	khty
𫏄	khaf
𫏅	khmd
𫏆	khny
𫏇	khaw
𫏈	khiq
𫏉	khqk
𫏊	khwf
𫏋	khtj
𫏌	khgo
𫏍	khnt
𫏎	khvq
𫏏	khge
𫏑	khlq
𫏒	khwc
𫏓	khtx
𫏖	khec
𫏗	khwc
𫏘	khil
𫏙	khrv
𫏚	khwk
𫏛	khyh
𫏜	khlg
𫏝	khog
𫏞	khor
𫏟	khul
𫏠	khjq
𫏡	khqe
𫏢	khte
𫏣	khgg
𫏤	khye
𫏥	khyn
𫏦	khvh
𫏧	khfj
𫏨	khqd
𫏩	khkp
𫑍	khgp
𫑡	kjnb
𫑣	kgmb
𫖦	kdmk
𫖲	kmdm
𫘘	khtc
𫚾	kgdo
𫛗	kako
𫛫	kmqg
𫜝	kkxf
𫜸	kxg
𪟔	lwwj
𪟗	lksj
𪟞	llft
𪟡	llsk
𪟦	llwy
𪟧	llll
𪢨	lyi
𪢩	lgig
𪢪	ludk
𪢫	llk
𪢬	ljxx
𪢭	luog
𪢮	lyos
𪢯	lahq
𪢰	lkmy
𪥺	lalv
𪪮	lpd
𪮃	lrrj
𪯇	lgcc
𪴾	lyhg
𪽇	lvn
𪽈	lnrt
𪽊	lfqn
𪽌	lyy
𪽍	lskf
𪽎	lskg
𪽏	lwgc
𪽑	lqrh
𪽒	lycq
𪽓	ldkh
𪽔	lhqn
𪽘	lfqf
𪽘	lfwf
𪽙	ldwh
𪽜	lnhc
𪽝	lfcm
𪽟	lqou
𪽢	lwyo
𪽤	lllg
𪽥	lxxu
𪽦	lugt
𪾖	lwvo
𪾜	lful
𫃙	lony
𫅀	lfnb
𫅁	lwxb
𫅂	ldf
𫅄	liqb
𫅅	lyjj
𫅇	lqf
𫅈	lxxw
𫅉	lsgn
𫅊	lkfk
𫅋	lwgj
𫅌	lfuf
𫅍	lued
𫆿	leop
𫎚	lmqh
𫏐	lrkh
𫏕	lcah
𫏲	lfnn
𫏳	lat
𫏴	lrg
𫏶	ldww
𫏷	lhfg
𫏸	lqdn
𫏹	ltfh
𫏺	lefc
𫏾	lltk
𫏿	ltfl
𫐀	lias
𫐃	llel
𫐄	lgqn
𫐅	lmh
𫐆	ldln
𫐇	lmwy
𫐈	ldcy
𫐉	lwyc
𫐌	luah
𫐍	ltmt
𫐎	ldsk
𫐏	lmfk
𫐐	lvqn
𫐑	lpnn
𫐒	lqyg
𫐓	lcbs
𫐔	lfcl
𫐕	ldhv
𫐖	lnwe
𫐗	logy
𫐘	ldgn
𫐙	llll
𫐪	lqip
𫑊	lkmp
𫑤	lebh
𫕾	lfhd
𫛐	lako
𫛤	lkqg
𫜙	lfon
𫜚	lfon
𫜛	lfoh
𫜞	lfox
𪞎	mdd
𪞲	mhkg
𪞴	myfk
𪞵	mfvd
𪥠	mmmd
𪧿	mwiy
𪨢	mghu
𪨣	mtnb
𪨥	mbn
𪨦	mrnn
𪨧	mwxb
𪨨	myhy
𪨩	mlnn
𪨪	mmmg
𪨫	mqtb
𪨬	myxy
𪨭	mxcy
𪨮	mxcu
𪨰	mmag
𪨱	miqb
𪨲	mrmj
𪨳	mtfh
𪨴	mriy
𪨶	mdlj
𪨷	mgod
𪨸	mkqw
𪨹	mkmw
𪨺	muwc
𪨻	mdlf
𪨼	mdfi
𪨽	muxf
𪨾	mepc
𪨿	myjn
𪩀	mnth
𪩁	mbeg
𪩂	mfmf
𪩃	mjgh
𪩄	mmtk
𪩅	mrgf
𪩆	mrhb
𪩇	movf
𪩈	mdtt
𪩉	mgef
𪩊	mldn
𪩋	mowv
𪩌	mxdm
𪩍	mgjf
𪩎	mmmv
𪩏	mynx
𪩐	mpwy
𪩑	mydn
𪩒	mnug
𪩓	magf
𪩓	magh
𪩔	muja
𪩕	mwxc
𪩖	mnbb
𪩗	mafr
𪩘	mfmd
𪩙	makf
𪩚	mwgj
𪩛	mdhb
𪩜	mqqc
𪩝	mugc
𪩞	mqaa
𪩟	mhbn
𪩠	mgmx
𪩰	magn
𪩳	mhgk
𪩴	mhug
𪩷	mhuf
𪩸	mhfm
𪩹	mhrf
𪩻	mhpj
𪩼	mheo
𪩽	mhhd
𪩿	mhjc
𪬋	mnmn
𪮚	mumr
𪱘	maev
𪵌	mcwq
𪹭	mhko
𪽉	mgeu
𫂳	mou
𫅆	mqqv
𫅥	mnng
𫆜	mwwx
𫆫	mwwc
𫆭	mwwp
𫆸	mwwf
𫆺	mwwh
𫊭	mdju
𫌩	mqqk
𫌭	mqtt
𫎏	mgfh
𫎐	mtnn
𫎑	mqhh
𫎒	myn
𫎓	mpgg
𫎕	mgmh
𫎖	mwgk
𫎗	mgik
𫎙	mukq
𫎝	mxxr
𫎞	mnhh
𫎟	mftj
𫎢	myin
𫎦	mdxt
𫎧	mqkg
𫎨	mwgi
𫎩	mpws
𫎪	musy
𫎫	msjh
𫑌	mnmp
𫑑	mnmp
𫖮	mndm
𫖼	mfgs
𫖽	mftc
𫖿	mfud
𫗀	mfiu
𫗁	mfvp
𫗂	mfvp
𫗃	mfwn
𫗄	mfwn
𫗆	mtjn
𫗇	mqjd
𫗈	mqfb
𫗉	mqdh
𫗊	mquj
𫗋	mqgt
𫘲	mevj
𫘳	mevp
𫘴	menf
𫚷	mmgo
𫚽	mtfo
𫛃	mgyo
𫛝	myqg
𫛲	mfkg
𫜳	mfqn
𪜐	nwxv
𪜒	nfkd
𪜖	nfmd
𪜡	ntha
𪟨	nxv
𪠪	nhfc
𪨉	ngmk
𪨊	nwwi
𪨋	ntfd
𪨌	nuav
𪨍	nwmc
𪨎	nylk
𪨏	nhie
𪨐	nyuy
𪨑	nylk
𪨒	nakf
𪨓	nymk
𪨔	nbhq
𪨕	ntfm
𪨖	ntfl
𪨗	nttj
𪨘	nqak
𪨙	ntff
𪨚	nuag
𪨛	nuaf
𪨜	nyth
𪨝	ntfj
𪨞	novh
𪨟	ntfj
𪨠	novf
𪨡	nfuh
𪩯	nydg
𪫝	ngnn
𪫞	nfg
𪫟	nsy
𪫡	ndln
𪫢	nhbh
𪫣	nhg
𪫤	ncqn
𪫦	ndag
𪫧	nskg
𪫨	naqy
𪫪	nmkg
𪫬	nhgf
𪫭	nftn
𪫮	ndjg
𪫯	naoy
𪫲	npvg
𪫸	nfcb
𪫹	nwwk
𪫺	nwgi
𪫻	npfq
𪫿	napy
𪬀	ntln
𪬁	ntfx
𪬃	npeg
𪬉	nsfg
𪬌	njtl
𪬍	nhkn
𪬏	ntjg
𪬑	nnff
𪬔	ngqi
𪬕	ngcj
𪬖	nuwy
𪬗	ntgf
𪬘	nuwl
𪬙	nike
𪬚	nprw
𪬜	nyod
𪬝	nugn
𪬞	nnhg
𪬠	nakk
𪬡	njcm
𪬢	njhl
𪬣	nrnk
𪬦	npgw
𪬧	nnyi
𪬨	njgf
𪬭	nnwh
𪬮	nbkg
𪬰	nhxf
𪬱	nlkm
𪬶	nxiu
𪬷	ngjf
𪬸	nuto
𪬹	nylj
𪬺	nptl
𪬻	ntmt
𪬾	noqb
𪭃	nghl
𪭄	nptm
𪭆	nuht
𪭇	nugy
𪭈	nmmy
𪯊	nhth
𪯖	nwet
𪯚	ntft
𪴫	nfqw
𪴲	ndjw
𪵓	ngcc
𪸍	nou
𪺞	nhdy
𪺟	nhdl
𪺠	nhdn
𪺡	nhdl
𪽗	nygb
𪽛	nawl
𫅤	nwgc
𫅧	nudh
𫅨	nlj
𫅩	ngjq
𫅪	ndjd
𫅮	nujn
𫅯	ngkp
𫅲	ntun
𫆃	nhtb
𫇂	ngcb
𫊼	nju
𫌏	nhde
𫐹	nhyp
𫖈	nafj
𫖍	nhkh
𫖏	nhkc
𫚮	nwvo
𫛊	nuto
𫛵	nbmg
𪢾	off
𪥢	oyod
𪩾	ogwy
𪪷	owva
𪯅	odfc
𪴍	oyms
𪴨	oguw
𪸎	otmn
𪸏	otnn
𪸐	ovyy
𪸑	ofqn
𪸒	ogxg
𪸔	ohg
𪸕	ornn
𪸖	opwu
𪸗	ocqn
𪸘	ofcy
𪸙	ofiy
𪸚	odkg
𪸛	ogyy
𪸜	olwy
𪸝	okln
𪸞	oqiy
𪸟	oqhy
𪸠	oyni
𪸡	oxcy
𪸢	onhy
𪸤	odnt
𪸥	obg
𪸧	okmh
𪸨	oesy
𪸩	oplh
𪸪	ong
𪸫	ogjq
𪸬	oakd
𪸭	omy
𪸮	ojdy
𪸯	oevg
𪸰	otlk
𪸱	oyfy
𪸲	ocvk
𪸳	orvk
𪸴	odsk
𪸵	ogah
𪸶	oaat
𪸷	ofqf
𪸸	omaw
𪸹	ohet
𪸺	ojqb
𪸻	ojyc
𪸼	omfk
𪸽	owgf
𪸾	oevh
𪹁	oblg
𪹄	ogmn
𪹅	odmf
𪹆	odae
𪹇	omdo
𪹈	ojgh
𪹊	owgj
𪹋	otky
𪹍	ownd
𪹎	opfe
𪹏	ougd
𪹐	oqko
𪹒	odaj
𪹓	ogoj
𪹔	ogtk
𪹖	omdt
𪹘	otwt
𪹙	otec
𪹚	oupy
𪹛	oube
𪹜	oylh
𪹝	oofo
𪹞	opuh
𪹟	ovmy
𪹠	ocwy
𪹡	osse
𪹢	okht
𪹣	ohag
𪹤	oqfc
𪹥	owfi
𪹦	olou
𪹧	oumd
𪹨	oyvh
𪹪	ogfn
𪹫	ofke
𪹯	owys
𪹰	oycy
𪹲	oyct
𪹳	onty
𪹴	odap
𪹵	ossh
𪹷	ojfe
𪹹	oujn
𪹺	oodm
𪹻	ovas
𪹼	ojan
𪹽	oopk
𪹾	opwi
𪺀	onyf
𪺁	oflm
𪺃	oqnf
𪺄	oelb
𪺅	optn
𪺆	oelb
𪺇	oyby
𪺈	oght
𪺉	ohad
𪺊	olkp
𪺌	oipf
𪾚	ovpl
𫂴	obn
𫂵	ojf
𫂶	otfh
𫂷	otyf
𫂸	oamh
𫂹	odg
𫂺	olg
𫂻	ohjg
𫂼	oqiy
𫂽	oadt
𫂾	oldy
𫃀	opvg
𫃁	ofiy
𫃂	obcy
𫃃	orgb
𫃄	owcn
𫃅	oylk
𫃇	okbg
𫃈	ovhn
𫃊	oafx
𫃋	oqfh
𫃌	onae
𫃍	oyvh
𫃎	oyfq
𫃏	ojyi
𫃐	ouny
𫃑	oool
𫃒	oaan
𫃓	omnp
𫃔	ohkb
𫃕	ouxn
𫃖	otvb
𫃗	ofno
𫃘	olaf
𫎇	opge
𫏻	ovlh
𫐷	ovpd
𫐽	oitp
𫑔	oopp
𫒄	ocdf
𫜏	oqax
𪞏	pqbb
𪞐	pwbf
𪞑	pwkh
𪞒	pfqf
𪞓	pwye
𪞔	pqbc
𪞕	pdhl
𪠮	pwwc
𪠹	pykf
𪥔	pwad
𪧅	pgmj
𪧆	pnyu
𪧇	pnhd
𪧈	plf
𪧉	pwer
𪧊	prkf
𪧋	pqvf
𪧌	pcsu
𪧍	pfqh
𪧎	pkhu
𪧏	ploi
𪧐	pwrf
𪧑	pawu
𪧒	pwtk
𪧓	pirf
𪧔	pfjl
𪧕	pfrm
𪧖	prou
𪧗	pwwl
𪧘	povf
𪧙	pccv
𪧚	pbpf
𪧛	pdji
𪧜	pfyt
𪧝	paao
𪧞	pttu
𪧟	pnte
𪧠	pntg
𪧢	pfwy
𪧣	pati
𪧤	ptmt
𪧥	ppym
𪧦	pfji
𪧧	pgcf
𪧨	pjbc
𪧩	pmdv
𪧪	pvtl
𪧫	pdcu
𪧬	psgm
𪧭	pusr
𪧮	pcba
𪧯	ptha
𪧰	pgke
𪧱	pfjk
𪧲	pssc
𪧳	pswf
𪧴	pnlw
𪧵	ppgv
𪧶	pglj
𪧼	pqdf
𪩶	pqdh
𪪹	pela
𪬂	pynn
𪬅	pdnu
𪬛	pwwn
𪳨	pqfs
𪹀	poch
𪹿	pgio
𪽣	pujl
𪾺	pnth
𫀃	pymy
𫀃	pymw
𫀅	pyhk
𫀇	pydi
𫀈	pymk
𫀉	pytl
𫀊	pyye
𫀋	pydw
𫀌	pygy
𫀍	pyjy
𫀎	pyyg
𫀐	pygh
𫀑	pyhj
𫀒	pyjr
𫀓	pykn
𫀔	pyqs
𫀕	pyvn
𫀖	pyrq
𫀗	pyvq
𫀘	pyvi
𫀚	pyjl
𫀛	pybb
𫀞	pywk
𫀠	pyih
𫀡	pytc
𫀢	pymc
𫀣	pytw
𫁊	pwyn
𫁋	pqmk
𫁌	pqgf
𫁍	pwri
𫁎	pwan
𫁏	pwwt
𫁐	pwvt
𫁑	pqkn
𫁒	pqwy
𫁓	pwwb
𫁔	pwag
𫁕	pqql
𫁖	pqrc
𫁗	pqrm
𫁘	pwxf
𫁙	pqqv
𫁚	pqqf
𫁛	pqaa
𫁜	pwdq
𫁝	pqtk
𫅃	pqjj
𫅭	prgn
𫆴	pnte
𫋲	puaq
𫋳	puyn
𫋵	pujh
𫋶	puvh
𫋷	puch
𫋸	pude
𫋹	puaq
𫋺	puiq
𫋻	puwc
𫋼	puxi
𫋽	puqe
𫋾	pudn
𫋿	pust
𫌀	pugm
𫌁	pufn
𫌂	putv
𫌃	puth
𫌄	pucd
𫌅	pujr
𫌆	puvc
𫌇	pubc
𫌈	puwm
𫌉	puuo
𫌊	puaf
𫌋	puju
𫌌	pumi
𫌐	puft
𫌑	puuj
𫌒	puxq
𫌓	pumu
𫌔	puvd
𫌕	pudh
𫌖	pufl
𫌗	puyf
𫌘	puoc
𫌙	putj
𫐂	plvl
𫐱	pfip
𫐲	pghp
𫐸	pahp
𫑈	pjmp
𫖫	pqdm
𫚲	pqwo
𫛏	pwyo
𫛕	pqto
𫛙	pqto
𫛢	psqg
𫛩	pvqg
𪞁	qkqc
𪞂	qkqj
𪟚	qkln
𪟟	qqlv
𪠞	qqfc
𪠣	qcu
𪡘	qqkh
𪤷	qmhh
𪤸	qhqh
𪤹	qoy
𪤺	qqgn
𪤻	qqhc
𪤼	qyvb
𪤾	qfje
𪤿	qqff
𪥯	qhvc
𪥸	qrvb
𪧷	qfu
𪩨	qlpn
𪬎	qvnc
𪬽	qvnk
𪯏	qrnt
𪱫	qkxe
𪲽	qsrr
𪴵	qrhf
𪹉	qvmo
𪹌	qlqo
𪹸	qsgo
𪺘	qvhm
𪺝	qqrh
𪺷	qtwb
𪺸	qtqv
𪺹	qtvc
𪺺	qtlt
𪺻	qtpe
𪺼	qtde
𪺾	qtdf
𪺿	qtug
𪻀	qtwa
𪻁	qtug
𪻂	qtrh
𪻃	qtth
𪻄	qtud
𪻅	qtcm
𪻆	qtrc
𪻇	qttk
𪻈	qtxj
𪻉	qtyy
𪻊	qtfe
𪻋	qtyf
𪻌	qtli
𪽕	qnll
𪾎	qblf
𪾐	qkql
𪾘	qxxl
𫂿	qsou
𫊱	qiju
𫌨	qimq
𫌮	qedn
𫌯	qetj
𫌰	qejr
𫌱	qenh
𫎛	qaqm
𫐶	qkqp
𫐻	qbtp
𫑁	qtdp
𫑂	qrmp
𫑗	qtbh
𫑙	qytb
𫑨	qobh
𫒂	qijf
𫒆	qhg
𫒇	qtan
𫒈	qvf
𫒉	qbh
𫒊	qdhh
𫒋	qty
𫒌	qwjh
𫒍	qtfh
𫒎	qiy
𫒏	qlg
𫒐	qkxb
𫒑	qwfn
𫒒	qrgg
𫒓	qqhy
𫒔	qcfg
𫒕	qfff
𫒖	qsg
𫒗	qjxt
𫒘	qrmh
𫒙	qpfy
𫒚	qyoy
𫒛	qpbg
𫒜	qyfn
𫒜	qhaf
𫒝	qgjq
𫒞	qaah
𫒟	qwty
𫒠	qtxi
𫒡	qtnh
𫒢	qpqf
𫒤	qybg
𫒥	qynn
𫒦	qfhg
𫒧	qfy
𫒨	qfjh
𫒩	qdwf
𫒪	qvqn
𫒫	qrqy
𫒬	qwqq
𫒭	qpgy
𫒮	qpxc
𫒯	qcjq
𫒰	qfth
𫒱	qjtd
𫒲	qrdf
𫒳	qtky
𫒴	qptk
𫒵	qukc
𫒶	qbkb
𫒷	qngf
𫒸	qfkq
𫒹	qlqn
𫒻	qych
𫒼	qubp
𫒽	qooq
𫒾	qxmw
𫒿	qaqh
𫓀	qafl
𫓁	qmpi
𫓂	qwga
𫓃	qphw
𫓄	qfkf
𫓅	qduh
𫓆	qfgf
𫓇	qgmi
𫓈	qgym
𫓉	qjgf
𫓊	qhgc
𫓋	qhhh
𫓌	qtwk
𫓍	qttt
𫓎	qxdx
𫓏	qdgt
𫓐	qmau
𫓑	qaqn
𫓒	qmae
𫓔	qugt
𫓕	qyjg
𫓗	qhaf
𫓘	qyww
𫓙	qxwy
𫓚	qnyf
𫓛	qddj
𫓜	qyjd
𫓝	qggq
𫓞	qssk
𫓟	qkkc
𫓠	qfnb
𫓡	qlft
𫓢	qnlw
𫓣	qjxo
𫓤	qtag
𫓥	qwy
𫓦	qbg
𫓧	qfwy
𫓨	qat
𫓩	qwwy
𫓪	qwcy
𫓫	qwgn
𫓬	qamh
𫓭	qmdy
𫓮	qqvg
𫓯	qffg
𫓰	qdgt
𫓱	qtdj
𫓲	qqjg
𫓳	qpyn
𫓴	qcrh
𫓵	qdfe
𫓶	qkeg
𫓷	qtnh
𫓸	qgot
𫓹	qadw
𫓺	qhal
𫓻	qwyn
𫓼	qtkg
𫓽	qpfi
𫓾	qyce
𫓿	qoqw
𫔀	qgli
𫔁	qfam
𫔂	qjgh
𫔃	qjtq
𫔄	qcbs
𫔅	qfpi
𫔆	qlfc
𫔇	qtlx
𫔈	qube
𫔉	qmmv
𫔊	qpwj
𫔋	qffw
𫔌	qaet
𫔍	qtol
𫔎	qcbk
𫔏	qnbb
𫔐	qfkc
𫔑	qylg
𫔒	qceo
𫔓	qfwy
𫔔	qmwk
𫔕	qodm
𫖰	qqdm
𫗞	qnfh
𫗟	qnfq
𫗠	qnty
𫗡	qndg
𫗢	qntf
𫗣	qnnt
𫗤	qndv
𫗥	qnpl
𫗦	qngy
𫗧	qngi
𫗨	qnye
𫗩	qnlq
𫗪	qntv
𫗫	qnde
𫗬	qndd
𫗭	qnle
𫗮	qnrg
𫗯	qnwd
𫗰	qnwp
𫗱	qnuo
𫗲	qnar
𫗳	qnxj
𫗴	qnyg
𫗵	qnye
𫙏	qofh
𫙐	qoaj
𫙑	qomc
𫙒	qoxh
𫙓	qdkq
𫙔	qohn
𫙕	qopw
𫙖	qonx
𫙗	qona
𫙘	qosg
𫙙	qoqc
𫙚	qoth
𫙛	qodi
𫙜	qoyv
𫙝	qoud
𫙞	qocc
𫙟	qovh
𫙠	qoey
𫙡	qorn
𫙢	qogs
𫙤	qosm
𫙥	qoik
𫙧	qorp
𫙨	qowc
𫙩	qouk
𫙪	qovd
𫙫	qodn
𫙬	qoml
𫙭	qdqu
𫙮	qoqs
𫙯	qowe
𫙰	qoxl
𫙱	qofn
𫙲	qoih
𫙳	qotf
𫙴	qoyw
𫙵	qonj
𫙶	qoxl
𫙷	qokm
𫙸	qoua
𫙹	qomj
𫙺	qokt
𫙻	qopl
𫙼	qowu
𫙽	qoay
𫙾	qohf
𫙿	qoqc
𫚀	qour
𫚁	qoum
𫚂	qofy
𫚄	qodl
𫚅	qovq
𫚆	qodm
𫚇	qonj
𫚈	qggg
𫚉	qgag
𫚊	qgnr
𫚋	qgfy
𫚌	qgit
𫚍	qgwv
𫚎	qggw
𫚏	qgsg
𫚐	qgmd
𫚑	qgnt
𫚒	qgxj
𫚔	qglk
𫚕	qgjh
𫚗	qgwk
𫚘	qgwf
𫚙	qggy
𫚚	qgbn
𫚛	qguq
𫚜	qgfq
𫚝	qgjs
𫚠	qgub
𫚡	qgvh
𫚢	qgav
𫚣	qgwq
𫚤	qgux
𫚥	qgnc
𫚦	qgpk
𫚧	qggj
𫚨	qgub
𫚩	qgfe
𫚪	qgck
𫚫	qgks
𫚬	qgpe
𫚭	qgvn
𫚵	qtbo
𫚹	qbwo
𫛖	qtco
𫛞	qynw
𫛣	qynw
𫛭	qtgg
𫛺	qynd
𫛾	qegg
𫜅	qyne
𪟇	rwjh
𪟘	rgln
𪠗	rjbk
𪠭	rcbg
𪢈	rgkv
𪥙	rkad
𪨵	rfcm
𪩢	rhkh
𪪱	rgpd
𪭜	rqy
𪭝	rfnh
𪭞	rtxy
𪭟	rtfh
𪭠	rqwy
𪭡	rwfh
𪭢	rwwy
𪭣	rnny
𪭤	rghg
𪭥	rdag
𪭦	rkqn
𪭧	rqiy
𪭨	rtdy
𪭩	rway
𪭪	rmmg
𪭫	rsyn
𪭬	rdmh
𪭭	rrqa
𪭮	rwww
𪭯	rwfc
𪭰	rudh
𪭱	runw
𪭲	rcdh
𪭳	rvey
𪭴	rfhy
𪭵	rgmw
𪭶	rkkh
𪭷	rksy
𪭸	rkuf
𪭹	rvqn
𪭺	rqfy
𪭻	rtgh
𪭼	rtjh
𪭽	ryfy
𪭾	rueg
𪭿	rnhf
𪮀	rbfq
𪮁	rgmj
𪮂	rgub
𪮄	rhvv
𪮅	rtsy
𪮆	rrag
𪮇	rqnk
𪮈	rwgq
𪮉	rydh
𪮊	ryof
𪮋	rvij
𪮌	rgcj
𪮍	rafs
𪮎	rayx
𪮏	rlny
𪮐	rkkk
𪮑	rrhg
𪮒	rrhg
𪮓	rtda
𪮔	ritk
𪮕	rnuh
𪮖	rxqc
𪮗	rdft
𪮘	rmth
𪮙	raaw
𪮛	rjff
𪮜	rtgf
𪮝	rtkl
𪮞	rtrw
𪮟	rwqq
𪮠	ryon
𪮡	ryve
𪮢	rdri
𪮤	rmee
𪮥	rtek
𪮦	rtjf
𪮧	ryvh
𪮨	rips
𪮩	roeg
𪮪	rnfy
𪮫	rajt
𪮬	rfkk
𪮭	rfhi
𪮮	rhja
𪮯	rkbh
𪮰	runy
𪮱	rqje
𪮲	rugw
𪮳	ryoj
𪮴	rnov
𪮵	rgxw
𪮶	rgkm
𪮷	rwgu
𪮸	rsdp
𪮹	rtdh
𪮺	rvhl
𪮻	rlrj
𪮼	rtgo
𪮽	rrrm
𪮾	ryns
𪮿	rynt
𪯀	rlkc
𪯁	rnay
𪯂	rywn
𪯃	raue
𪯄	rgjl
𪯬	rgkf
𪯱	rty
𪳔	riwa
𪴄	rifb
𪴞	rise
𪴭	rcqw
𪵤	rnsk
𪵥	rntu
𪵧	rngt
𪺎	rhyq
𪺐	rhyc
𪺑	rhye
𪺖	rhys
𪼳	rcyd
𪼴	rcyy
𪽠	riqm
𪽧	rgkh
𪽻	rsy
𪽼	ryy
𪽽	rrgg
𪽾	rmu
𪽿	rqkq
𪾀	rakg
𪾁	rifc
𪾂	rgkq
𪾃	rnhh
𪾄	rrvc
𪾅	rugt
𪾑	rqnl
𪿃	rhvf
𫄺	rmkf
𫄻	rmwy
𫄼	rmas
𫄾	rmem
𫅫	rdfn
𫆈	rntb
𫌪	remq
𫎘	rrmu
𫐋	rvyl
𫐧	rfwp
𫐺	rvnp
𫑇	radp
𫖞	rydm
𫖵	rgmm
𫘶	rgyk
𫙈	rqcw
𫙉	rqcq
𫙊	rqcd
𫙍	rqcl
𫙎	rqcf
𫚺	rewo
𫛒	rgjo
𫛘	rrro
𪜅	sufj
𪝗	swwq
𪠧	scy
𪡑	skiv
𪢦	sksh
𪣖	svyf
𪥄	sdu
𪬓	sifn
𪬟	ssen
𪱱	sghu
𪱲	shg
𪱳	skg
𪱴	svg
𪱷	smy
𪱸	swuy
𪱹	siy
𪱺	sdag
𪱻	ssg
𪱽	seh
𪱾	sqiy
𪱿	stbg
𪲀	srgg
𪲂	snjg
𪲃	sadg
𪲄	sdoy
𪲆	sdnf
𪲇	smag
𪲈	shhg
𪲉	srgk
𪲊	smyy
𪲋	stfh
𪲌	symy
𪲍	sumh
𪲎	syjh
𪲏	sxty
𪲐	sgqb
𪲒	sfoy
𪲓	sgku
𪲔	sgmy
𪲖	sksy
𪲗	sloy
𪲘	strt
𪲙	staf
𪲚	sieg
𪲛	sonn
𪲝	sysy
𪲞	sudn
𪲟	sfuf
𪲡	ssfc
𪲢	sfhn
𪲤	smqb
𪲦	sitr
𪲧	swwh
𪲨	sqrn
𪲩	spjg
𪲮	syny
𪲯	sveh
𪲰	sqmd
𪲱	syod
𪲲	sdkc
𪲳	sgms
𪲴	sdks
𪲵	ssbm
𪲶	sftk
𪲷	slsy
𪲺	sjqb
𪲻	srdh
𪲼	swyg
𪲾	sesk
𪳀	sujg
𪳁	syac
𪳂	suth
𪳃	spvm
𪳄	sypm
𪳅	sitk
𪳆	scel
𪳇	slkp
𪳉	ssny
𪳊	sdes
𪳋	sgnn
𪳌	sfel
𪳍	sbcc
𪳏	skky
𪳑	sjoy
𪳒	sjiq
𪳕	stux
𪳖	stap
𪳗	sepc
𪳘	spge
𪳚	spgi
𪳛	svfj
𪳜	sbio
𪳝	ssgo
𪳞	sftt
𪳟	ssqq
𪳠	shxr
𪳡	smhx
𪳢	smfg
𪳣	shmk
𪳤	stfp
𪳥	sqjn
𪳧	sdqb
𪳩	syhq
𪳪	sihv
𪳬	snfy
𪳮	sfpu
𪳯	ssif
𪳰	sajs
𪳱	skhh
𪳲	stdj
𪳳	sthx
𪳴	smlc
𪳵	seto
𪳶	spfu
𪳸	suef
𪳹	sbue
𪳺	slkm
𪳻	scbs
𪳽	ssdl
𪳾	sfal
𪴀	smau
𪴁	skhq
𪴂	sjly
𪴃	stmd
𪴅	stgh
𪴆	suxn
𪴇	syno
𪴈	scbs
𪴉	sxxt
𪴊	sgmu
𪴋	skak
𪴌	stpn
𪴎	spxm
𪴏	sbjc
𪴐	sfvp
𪴑	sddj
𪴒	srcy
𪴓	stjy
𪴔	spdi
𪴕	snwj
𪴖	sfss
𪴗	suxw
𪴘	sjfc
𪴙	stfm
𪴚	stgo
𪴛	ssfi
𪴜	sfsh
𪴝	sqoj
𪴟	sfcl
𪴠	sfdp
𪴡	stji
𪴢	sdhh
𪴣	spwm
𪴤	swfq
𪴥	spgm
𪴦	sysf
𪴧	stui
𪴺	swwh
𪵝	sstn
𪵿	sriy
𪶛	shiu
𪺂	syso
𪾌	sklf
𫃉	sogn
𫇒	swwv
𫌚	sty
𫌛	smth
𫌞	shqb
𫌬	sfiq
𫌺	syf
𫎉	sfie
𫐠	spi
𫑬	slab
𫑳	sgvy
𫑴	sgdb
𫑵	sgld
𫑶	sggu
𫑷	sgwi
𫑸	sgnn
𫑹	sgsw
𫑺	sgwh
𫑻	sgtk
𫑼	sgwf
𫑽	sgni
𫑾	sgyi
𫑿	sgao
𫖟	svdm
𫖺	sqqm
𫛌	skso
𫛠	snqg
𫛽	ssqg
𫜃	sjqg
𫜐	swwm
𫜴	ssoa
𪜍	tfiq
𪜎	tdjm
𪜏	tdut
𪝲	towg
𪞄	tfqd
𪞳	tfum
𪞶	tygb
𪟏	tguj
𪟕	tadj
𪟳	tfqh
𪢡	tfkk
𪢶	tff
𪤈	temf
𪤵	tkib
𪥌	tmwd
𪥝	tgjd
𪥴	thvf
𪧻	tmdf
𪩵	tfhh
𪫋	tyy
𪫌	tdxn
𪫍	tfny
𪫎	tkty
𪫏	tkht
𪫐	tqky
𪫑	tlge
𪫒	thpx
𪫓	tvfh
𪫔	tqdy
𪫕	txit
𪫖	tgjf
𪫗	tiqf
𪫘	thkh
𪫙	tlff
𪫛	tsse
𪫜	tbmt
𪬤	thnt
𪯉	tghc
𪵔	txgi
𪵖	tfnn
𪵗	tfne
𪵘	tfno
𪵙	tfnk
𪵚	tfnx
𪵛	tfni
𪵜	tfnd
𪵞	tfni
𪵟	tfnh
𪵠	tfnw
𪵡	tfnx
𪵢	tfnm
𪹮	tfno
𪺋	tqxo
𪺢	thge
𪺣	thgf
𪺤	thgj
𪺥	thgn
𪺦	thgj
𪺩	trta
𪺪	trdx
𪺬	trvj
𪺭	trtj
𪺯	troo
𪺰	trgl
𪺱	trff
𪺲	trgf
𪺳	tqth
𪺴	trah
𪺵	trdn
𪽀	tfkf
𪽁	tghy
𪽃	tgdh
𪽄	tgik
𪽆	tmfh
𪽐	tlwj
𪾝	telt
𪿂	tmgh
𪿈	tdsy
𪿉	tdit
𪿊	tdgg
𪿋	tdaw
𪿌	tdcs
𪿍	tdkj
𪿎	tdtf
𪿏	tdga
𪿐	tdlj
𫀦	tfqy
𫀧	taf
𫀨	tmqn
𫀩	ttfh
𫀪	tlg
𫀫	tmtn
𫀬	tqvg
𫀭	tvah
𫀮	tivg
𫀯	tvjg
𫀰	tiqb
𫀱	trgk
𫀲	tdqn
𫀴	tjfg
𫀵	tpgn
𫀶	tpfq
𫀷	tvyn
𫀸	tnnk
𫀹	tjeg
𫀺	tqtt
𫀻	tyvw
𫀼	tlny
𫀽	tjmy
𫀾	trit
𫀿	txey
𫁀	tvfp
𫁁	tkhl
𫁂	tlfc
𫁃	tetl
𫁄	tiie
𫁆	tfol
𫁇	trie
𫁈	tujn
𫁉	temq
𫁰	thu
𫁱	tbgf
𫁲	tfqb
𫁳	tfnh
𫁴	tuwu
𫁵	tufj
𫁶	tnyu
𫁷	tccu
𫁸	tdnt
𫁹	tamh
𫁺	togf
𫁻	twbf
𫁼	tmhy
𫁽	tnyw
𫁾	teu
𫁿	tlj
𫂀	tfpb
𫂁	tjdu
𫂂	ttxu
𫂃	tuyu
𫂄	tlnb
𫂅	trxj
𫂆	tlgy
𫂇	trqy
𫂈	tyny
𫂉	tvcb
𫂊	tsgh
𫂋	tafs
𫂌	tlwn
𫂍	tkjj
𫂎	tqjd
𫂏	tovy
𫂐	tdwi
𫂑	tdun
𫂒	tgri
𫂓	tftj
𫂔	tldt
𫂕	twuk
𫂖	tepc
𫂗	toyp
𫂘	tssg
𫂙	tgkt
𫂚	tstu
𫂛	tlki
𫂜	thmc
𫂝	tmwt
𫂞	tyvi
𫂟	tyfq
𫂠	tgjn
𫂡	tgmi
𫂢	tdwm
𫂣	tade
𫂤	tqje
𫂥	tglm
𫂦	tpyi
𫂧	tgki
𫂨	tffl
𫂩	tmgh
𫂪	ttdv
𫂫	tbuf
𫂬	ttqh
𫂭	teuy
𫂮	tadn
𫂯	tyny
𫂰	tfag
𫂱	tohh
𫃛	txnn
𫅱	thun
𫅹	tfil
𫅺	tfij
𫅻	tfia
𫅼	tfip
𫅽	tfij
𫅾	tfil
𫅿	tfim
𫆉	tobf
𫆎	thhb
𫇊	thpb
𫇋	thri
𫇌	thdn
𫇍	thdl
𫇖	tdyk
𫇘	tdgm
𫇚	tetf
𫇛	tehl
𫇜	teak
𫇝	tenc
𫇞	tejc
𫇟	tedn
𫇠	teff
𫇡	teai
𫇢	teut
𫇣	teut
𫋪	tlxx
𫋬	tluj
𫋭	tmdh
𫋮	tfkh
𫋯	trgh
𫋰	ttdh
𫋱	tmmh
𫌍	tdje
𫌦	tfqq
𫎂	tvwk
𫏪	tmdj
𫏫	tmda
𫏬	tmdt
𫏭	tmdt
𫏮	tmdp
𫏯	tmdc
𫏰	tmdu
𫏱	tmdj
𫐵	topi
𫑎	tthp
𫑢	tfth
𫒀	tltn
𫒃	tgjx
𫒅	tgjc
𫔦	tfua
𫖪	tndm
𫗅	thlj
𫗼	tjff
𫗽	tjtg
𫗽	tjwg
𫗾	tjfn
𫗿	tjnh
𫘀	tjft
𫘁	tjgm
𫘂	tjws
𫘃	tjuw
𫘄	tjpm
𫘎	trtc
𫙋	tjrc
𫙦	trqo
𫚞	tqtg
𫚟	tryg
𫚴	twvo
𫚶	tuho
𫛎	ttdo
𫛡	tpqg
𫜈	txgo
𫜤	thld
𫜵	tute
𪜜	uxbh
𪜣	ucwa
𪞌	ulyk
𪞍	uvok
𪞖	umyy
𪞗	umty
𪞘	uwgn
𪞙	uyy
𪞚	unyy
𪞛	ulg
𪞜	urg
𪞝	ucfh
𪞞	udnt
𪞠	uwyb
𪞡	uwfi
𪞢	udff
𪞣	uhaq
𪞤	uwyn
𪞥	upfi
𪞦	uleg
𪞧	uwyq
𪞨	uyps
𪞩	uawy
𪞪	uwqu
𪞫	ugkt
𪞬	uujh
𪞭	uffq
𪞮	ufwc
𪞯	uype
𪞰	uucy
𪟄	ubtj
𪟅	unwj
𪟍	uejh
𪟠	ujln
𪟪	uxgi
𪟶	ufik
𪟸	ufuy
𪠫	udrc
𪡳	ukck
𪥗	uejd
𪥘	uskd
𪥛	ujnd
𪥞	ugld
𪧹	uwgf
𪪃	uagw
𪪰	uspd
𪪶	upma
𪫃	uxhm
𪬄	uxhn
𪬐	uthn
𪬥	umqn
𪬫	ujnh
𪬴	usrn
𪭀	uytn
𪭂	ujdn
𪯐	upmt
𪯔	umqt
𪯙	upmt
𪯫	ufrg
𪱐	ujih
𪱗	uljn
𪲁	uqsu
𪲜	uwgs
𪲫	ubts
𪲿	udgi
𪳙	uwys
𪴴	ugow
𪵦	ujrn
𪷹	ujnk
𪽞	ujnl
𪽨	ugti
𪽩	uwev
𪽪	utay
𪽫	urhy
𪽬	ufii
𪽭	uge
𪽮	uhne
𪽯	uxhj
𪽰	ukhi
𪽱	upwl
𪽲	ugmd
𪽳	usvd
𪽴	uanm
𪽵	ubry
𪽶	ugkh
𪽷	ugun
𪽸	ufht
𪽹	ubjy
𪽺	udjq
𪿁	ujnh
𫁞	uqhh
𫁟	ufny
𫁠	ummg
𫁡	uqyg
𫁢	upgf
𫁣	uqeg
𫁤	uvug
𫁥	uyhk
𫁦	undg
𫁧	utff
𫁨	unhh
𫁩	ujng
𫁪	uuuf
𫁫	ubth
𫁬	utjr
𫁭	uool
𫁯	ujtb
𫅎	udbj
𫅏	uggh
𫅐	udmd
𫅑	udjg
𫅒	udna
𫅓	udud
𫅔	udve
𫅕	udda
𫅖	ugdk
𫅗	udfm
𫅘	ugak
𫅙	udmj
𫅚	ugdi
𫅛	udme
𫅝	ugdg
𫅟	ugdc
𫅠	ugds
𫅡	udnk
𫅦	ubtn
𫅬	ujng
𫇥	uhu
𫉓	umhi
𫋴	uyeu
𫎬	ujam
𫏽	ujnl
𫐚	usnn
𫐛	ugmi
𫐜	ucny
𫐝	uyyw
𫐼	upyp
𫑕	ujfp
𫑩	ugyb
𫑫	uqwb
𫑰	uegb
𫔘	uhk
𫔚	ukhk
𫔛	uwxv
𫔜	udd
𫔝	uhd
𫔞	umd
𫔟	uwai
𫔠	utui
𫔡	ugku
𫔢	ukkh
𫔣	utjk
𫔤	uyfh
𫔥	uadw
𫔧	uwww
𫔨	uwge
𫔩	uajd
𫔪	uujn
𫔫	ueed
𫔭	ugak
𫔮	ued
𫔯	uufk
𫔰	ucak
𫔱	uyoi
𫔲	uftb
𫔳	uyfh
𫔴	uwyd
𫔵	ugct
𫔶	uths
𫔷	ugan
𫔹	uyml
𫕿	udwd
𫖗	ujuf
𫖘	ujca
𫖙	ujhm
𫖚	ujpw
𫖛	ujah
𫖛	ujaf
𫖜	ujte
𫗶	uthh
𫗷	uths
𫗸	uthj
𫗹	uthy
𫗺	utht
𫗻	uthe
𫛅	ufho
𫛨	uaqg
𫛮	umig
𫛴	ujfg
𫜁	umig
𫜂	ujqg
𫜄	usgg
𫜟	usgn
𪜔	vmad
𪜗	vakg
𪜙	vdja
𪞋	vcew
𪟀	vyn
𪟓	vbjx
𪟖	vhgj
𪟙	vcln
𪠤	vcy
𪠨	vcu
𪠬	vdcy
𪡢	vkkj
𪡲	vkgd
𪥥	vthh
𪥦	vgxg
𪥧	vhg
𪥨	vjg
𪥩	vhcy
𪥪	vmmn
𪥫	vccy
𪥬	vcqn
𪥭	vmsh
𪥮	vhjg
𪥰	vpsh
𪥱	vgmi
𪥲	vtdc
𪥳	vkmh
𪥵	vng
𪥶	vdtb
𪥹	vyme
𪥻	vftp
𪥼	vgvv
𪥽	vdey
𪥾	vdqh
𪥿	vfnd
𪦀	vayn
𪦁	vtln
𪦂	vtmd
𪦃	vyhk
𪦄	vcjy
𪦅	vvlq
𪦆	vdpu
𪦇	vfff
𪦈	vajv
𪦉	viqy
𪦊	vkkn
𪦋	vwdc
𪦌	vuqv
𪦎	vyde
𪦏	vxin
𪦐	vvkt
𪦒	vhay
𪦓	vhna
𪦔	vwgk
𪦕	vwqq
𪦖	vups
𪦗	vdev
𪦘	vftt
𪦙	vatt
𪦚	vmty
𪦛	vpwd
𪦜	vifj
𪦝	vyby
𪦞	vnrg
𪦟	vbyu
𪦡	vgmi
𪦢	veqg
𪦣	vwtf
𪦤	vxii
𪦦	vfqy
𪦧	vfbh
𪦨	vlqj
𪦩	vmxt
𪦪	vtln
𪦫	vutk
𪦬	vahm
𪦭	vdwo
𪦮	vlll
𪦯	vooy
𪦰	vgkk
𪦱	vooj
𪦲	vckm
𪦳	vjgq
𪦴	vtuj
𪧾	vfmy
𪩡	vcb
𪩺	vpmw
𪪸	vdfa
𪫴	vnnu
𪫾	vrnu
𪬒	vctn
𪬵	vfjn
𪱛	vtef
𪱵	vsu
𪹂	vocf
𪹃	vkbo
𪹑	vkoo
𪺫	verh
𪽖	vfbl
𫄽	vhgm
𫌥	vhqq
𫐯	vwyp
𫐰	vqpv
𫑏	vfbp
𫕣	vyfv
𫖂	vfbd
𫖩	vlqm
𫖱	vedm
𫖳	vtkm
𫚻	vbwo
𫛀	vfbo
𫛆	veho
𫛇	vcxo
𫛪	vkqg
𫜢	vnug
𫜣	vnuu
𫜹	vngg
𪜓	wrhn
𪜧	wqy
𪜨	wgvg
𪜩	wqcy
𪜪	wqxn
𪜫	wnfg
𪜬	wfiu
𪜭	wlng
𪜮	whg
𪜯	wkln
𪜰	wty
𪜱	wtu
𪜲	wryy
𪜳	wnan
𪜴	wxcy
𪜵	wxjg
𪜶	wldy
𪜷	wesy
𪜸	wpbg
𪜹	wng
𪜺	wxfy
𪜻	wfoy
𪜼	wahh
𪜽	wjff
𪜾	wegl
𪜿	wjvg
𪝀	wqeg
𪝁	wekx
𪝂	wyjg
𪝃	wtcy
𪝄	wdun
𪝅	wsty
𪝆	wayn
𪝇	whmt
𪝈	wepc
𪝉	wtsy
𪝊	wyqg
𪝋	wshg
𪝌	walg
𪝍	wdeg
𪝎	wswc
𪝏	waqk
𪝐	wdjb
𪝑	wjlg
𪝒	wwdc
𪝓	wwae
𪝔	wqbn
𪝕	wwvl
𪝖	wamy
𪝘	wdep
𪝙	wfcl
𪝚	wjiq
𪝛	wrvc
𪝜	wwnh
𪝝	weud
𪝞	wuwl
𪝟	wxrr
𪝠	wlat
𪝡	wajd
𪝢	wlye
𪝣	wpdk
𪝤	wpgw
𪝥	wdmj
𪝦	wfkk
𪝧	wjoo
𪝨	wqao
𪝩	wudh
𪝪	wnhh
𪝫	wgoc
𪝬	wdyf
𪝭	whad
𪝮	wytq
𪝯	wujf
𪝰	wgcy
𪝱	wmwh
𪝳	wiaw
𪝴	wsdp
𪝵	wqyj
𪝶	wynf
𪝷	wfvq
𪝸	wafy
𪝹	wynt
𪝺	wfnc
𪝻	wgcs
𪝼	wmmv
𪝽	whmm
𪝾	wdej
𪞇	wgwv
𪞈	wxfj
𪞊	wumk
𪟐	wveh
𪟢	wgwl
𪟻	wywf
𪠁	wgkb
𪠩	wfic
𪣶	wtcf
𪣸	wtcf
𪥷	wrvf
𪦻	wgkb
𪪀	wnns
𪪳	wcaj
𪫫	wvyn
𪫱	wwvn
𪫶	wgnh
𪬪	whwn
𪬲	wvne
𪬼	wvnm
𪯌	wnnt
𪯰	wtuc
𪳦	wnns
𪴱	wcnw
𪴿	wfgh
𪵍	wgkc
𪷣	wnni
𪺛	wqrm
𪺜	wqvb
𪼈	wggg
𪼉	wgkg
𪼽	wwwn
𪼾	wwkn
𪽚	wwal
𪾗	wgvl
𪾙	wftl
𫅜	wyck
𫇓	wfsg
𫇕	wfkg
𫇙	wfkl
𫌠	wsgq
𫌸	wayf
𫎀	wwkw
𫎔	wfmu
𫎤	wvmm
𫐡	wgnp
𫐩	wwfp
𫐮	wgmp
𫑓	wnnp
𫒺	wnnq
𫓓	wftq
𫕚	wyww
𫕜	wngy
𫕽	wgkd
𫖄	wwnd
𫖤	wngm
𫖻	wcmj
𫖾	wgef
𫗎	wgvn
𫗏	wpde
𫗐	wgvg
𫗑	wpqc
𫗒	wgvv
𫗓	wptk
𫗔	wpsd
𫗕	wpff
𫗖	wgvd
𫗗	wpnh
𫗘	wptl
𫗙	wgvm
𫗛	wppj
𫗜	wpfj
𫗝	wgvl
𫚃	wfqo
𫚱	wvgc
𫚳	wvgk
𫚸	wvge
𫚼	wvge
𫚿	whto
𫛈	wvgy
𫛓	wvgh
𫛓	wvgf
𫛬	wtqg
𫛼	wgdg
𫜜	wgnj
𪟩	xgdu
𪟫	xxrg
𪢞	xtbk
𪦥	xxvf
𪪊	xqyy
𪪋	xxft
𪪺	xkg
𪪻	xgmw
𪪼	xxxf
𪪽	xtlg
𪪾	xkhc
𪪿	xbcy
𪫀	xnhh
𪫁	xemf
𪫂	xpgw
𪫄	xwyc
𪫅	xqoo
𪫇	xgom
𪫠	xxnu
𪫥	xhnu
𪭖	xgua
𪭗	xyxt
𪴬	xtgw
𪵊	xtdt
𪵕	xxwm
𪹩	xjxo
𪾞	xnjl
𫃚	xhy
𫃜	xkg
𫃝	xwnn
𫃞	xkhh
𫃟	xfiy
𫃠	xqnn
𫃡	xug
𫃢	xwsy
𫃣	xpbg
𫃤	xivg
𫃥	xkhy
𫃦	xegc
𫃧	xqjn
𫃨	xujn
𫃩	xvnf
𫃪	xgbu
𫃫	xdah
𫃬	xhic
𫃭	xegd
𫃮	xtyg
𫃯	xveh
𫃰	xcdd
𫃱	xvgi
𫃲	xivh
𫃳	xjqy
𫃴	xqmd
𫃵	xovg
𫃶	xitk
𫃷	xnhg
𫃸	xrev
𫃹	xiqp
𫃺	xjgg
𫃻	xpwk
𫃼	xouf
𫃽	xfvg
𫃾	xagy
𫃿	xefy
𫄀	xpff
𫄁	xaje
𫄂	xith
𫄂	xtvh
𫄃	xybt
𫄄	xnov
𫄅	xdgt
𫄆	xdyf
𫄇	xfal
𫄈	xaik
𫄉	xkhk
𫄊	xiyi
𫄋	xyff
𫄌	xkhv
𫄍	ximo
𫄎	xnlv
𫄏	xtdt
𫄐	xwvd
𫄑	xwyv
𫄒	xist
𫄓	xlfd
𫄔	xiuo
𫄕	xlhi
𫄖	xidl
𫄗	xiio
𫄘	xtei
𫄙	xnn
𫄚	xgxg
𫄛	xwyn
𫄜	xtfn
𫄝	xxhh
𫄞	xgig
𫄟	xtbn
𫄠	xgjg
𫄡	xmgk
𫄢	xwdy
𫄣	xpey
𫄤	xdpy
𫄥	xgmy
𫄦	xfcl
𫄧	xthp
𫄨	xqdh
𫄩	xtxu
𫄪	xfue
𫄫	xynd
𫄬	xans
𫄭	xtjt
𫄮	xecl
𫄯	xlwt
𫄰	xupy
𫄱	xfuk
𫄲	xajd
𫄳	xthh
𫄴	xyxf
𫄵	xfke
𫄶	xxkj
𫄷	xujn
𫄸	xtgo
𫄹	xmwk
𫆔	xfih
𫕙	xtvi
𫖝	xxdm
𫘖	xqac
𫙆	xwfh
𫙇	xuwh
𫚰	xxwo
𫛯	xyqg
𪜊	ynb
𪜋	ygat
𪜟	ybvc
𪜠	ymyu
𪜢	yhjf
𪜤	ywwy
𪜥	ylkh
𪜦	ypsl
𪞅	ycqk
𪞸	ybtf
𪞻	ybkd
𪞼	ybuw
𪞽	ybme
𪟑	yqkv
𪟒	yttj
𪟼	ywww
𪡍	ykqh
𪢓	yniw
𪤜	yyfy
𪥀	yylq
𪦍	ynvq
𪦽	ynab
𪧃	ybtf
𪨂	yogi
𪩧	ypsn
𪪌	ygmh
𪪍	yyi
𪪎	yghd
𪪏	yhne
𪪐	yayi
𪪑	ytdj
𪪒	yvtk
𪪓	ygik
𪪔	ydcv
𪪕	yfcw
𪪖	ytfc
𪪗	yvcb
𪪘	ygkc
𪪙	yjgd
𪪚	ybkd
𪪛	yhag
𪪜	ywht
𪪝	yvkc
𪪞	yfuk
𪪟	ykkn
𪪠	ywfe
𪪡	ydum
𪪢	yujd
𪪣	ypgl
𪪤	yfqg
𪪥	yudm
𪪦	ywho
𪪧	yxth
𪪨	yylo
𪪪	yach
𪫳	yenu
𪫼	ycfn
𪬆	ytnu
𪬳	ynnm
𪭘	ynan
𪭙	ynmk
𪭚	ynjh
𪭛	ynaj
𪯒	yptt
𪯕	ytwf
𪯛	ytgi
𪯜	ylkt
𪯞	ytdf
𪯠	ykj
𪯢	yyy
𪯣	ylf
𪯤	ywgk
𪯦	ymaw
𪯧	yqg
𪯨	ydpv
𪯩	ywyc
𪯪	yymk
𪯲	yrh
𪯳	ytcy
𪯴	yhkg
𪯶	ytgd
𪯷	yudh
𪯸	ytrg
𪯹	ydey
𪯺	ywgn
𪯻	ypgh
𪯼	yyjg
𪯽	ythc
𪯾	ykmy
𪯿	yamw
𪰀	yrla
𪰁	ywya
𪰂	yxjm
𪰃	ytaf
𪰄	ytja
𪰅	ytqb
𪰎	yjf
𪱮	ynem
𪱯	ynen
𪲪	ylks
𪴩	yqwy
𪵏	ydec
𪵵	ynie
𪸿	ybou
𪹱	ybdo
𪺮	ycph
𪽅	yqag
𫀥	ybmj
𫅞	yvck
𫆡	yceh
𫆥	yneq
𫆽	ycex
𫇄	ycee
𫋉	yntj
𫋡	ynjj
𫌲	yaj
𫌳	yvg
𫌴	yyy
𫌶	ygig
𫌹	ycyg
𫌻	yyey
𫌼	ylh
𫌽	yevg
𫌾	ytxi
𫌿	ygvv
𫍀	yqg
𫍁	yakh
𫍂	yith
𫍃	ycel
𫍄	ynuh
𫍅	ycbs
𫍆	yrvn
𫍇	ypwk
𫍈	ypqv
𫍉	yssy
𫍊	yahf
𫍋	yukg
𫍌	ycep
𫍍	yafy
𫍎	ykbt
𫍏	ynty
𫍑	yywy
𫍒	ypxm
𫍓	yuto
𫍔	yhaa
𫍕	yntw
𫍖	ynlw
𫍗	yecu
𫍘	ynfj
𫍙	ybn
𫍚	ytdy
𫍛	ywvn
𫍜	yfcy
𫍝	yanw
𫍞	ytuh
𫍟	ytbn
𫍠	yqbn
𫍡	ypxn
𫍢	yatq
𫍣	ymgk
𫍤	ytdj
𫍥	yiqn
𫍦	ypey
𫍧	ygoy
𫍨	ydfe
𫍩	ykmw
𫍪	ynny
𫍫	ydjn
𫍬	ymun
𫍭	yuvg
𫍮	ynbm
𫍯	ydgt
𫍰	ylny
𫍱	ymdj
𫍲	yvhc
𫍳	ytgf
𫍴	yovg
𫍵	ygqt
𫍶	ygct
𫍷	yrqc
𫍸	yynn
𫍹	yhag
𫍺	ytlt
𫍻	yfkk
𫍼	yujf
𫍽	ylge
𫍾	ypns
𫍿	yuen
𫎃	ywfu
𫎠	ynam
𫐤	ysyp
𫑃	ynjp
𫑉	ytmp
𫑟	ybh
𫑭	ynjb
𫒣	yogq
𫖎	yinh
𫖶	ynem
𫘵	ymkb
𫘷	ymkj
𫛻	yacg
𫜆	ynwg
𫜋	ynjl
𫜌	ynjw
𫜍	ynjk
𫜎	ynjj
𫜖	yfqk
𫜗	yssj
