---config@码表分类=主码-2
---config@码表别名=CJKExt_A
㐂	aaab
㐄	ahk
㐞	adwn
㒼	amhy
㓚	ajh
㓛	avn
㓸	anfj
㔆	aqaj
㔈	adjj
㔋	ahnj
㔑	awnv
㔮	akfx
㔯	amkd
㔰	aqhi
㔱	avwi
㔲	awyv
㔳	awym
㔴	alaw
㔵	annw
㔶	aujm
㔷	agmw
㔸	arhm
㗡	awex
㗨	atdk
㙠	atdf
㚽	agnv
㜸	awnv
㝻	akgt
㠫	amyw
㠬	akfw
㠭	aaaa
㢣	aqka
㣉	aet
㤅	aqnu
㤍	agnn
㥦	adwn
㦯	acgd
㦴	atkd
㦶	agcf
㧬	amyr
㧭	abrj
㪚	ajty
㪛	adwc
㪸	adwf
㫷	adwj
㬫	aukj
㬾	atde
㭉	asu
㭟	awsu
㯺	ahns
㰥	anqw
㰲	akgw
㰼	adww
㰽	ajvw
㱳	ajdq
㲟	amdn
㲨	abtn
㲯	ahnn
㳟	awiu
㳼	akgi
㷂	ahno
㷼	auko
㸐	akfo
㸦	ahyi
㸧	ahte
㹂	ahnh
㻨	ahny
㼢	ahkn
㼦	amyn
㼹	aynn
㽄	adwn
㽉	ahnn
㽍	afgn
㽎	adwq
㽐	afuo
㽑	afsf
䁂	ahnh
䂬	amyd
䃜	atdd
䅃	amyt
䊄	amyo
䑐	ahni
䑑	ahny
䑓	afpf
䑞	aooh
䒎	adac
䒐	alpc
䒒	angf
䒓	agnb
䒔	awu
䒕	aiu
䒖	anfj
䒗	atnb
䒘	atu
䒙	ahf
䒚	aitr
䒛	axnb
䒜	arhj
䒝	aqqu
䒞	apqb
䒟	amyf
䒠	adhj
䒡	axhj
䒢	aqbj
䒣	amff
䒤	ajf
䒥	agmh
䒦	atpu
䒧	afcu
䒨	atdu
䒩	atu
䒪	acaj
䒫	awau
䒬	afiu
䒭	anfu
䒮	apmy
䒯	apvy
䒰	aagf
䒱	abig
䒲	avta
䒳	amsu
䒴	adef
䒵	avbf
䒶	ajxr
䒷	atdf
䒸	atlf
䒹	adiu
䒺	axiu
䒻	amnb
䒼	amaf
䒽	amqq
䒾	ayeu
䒿	apef
䓀	afkf
䓁	affu
䓂	ayf
䓃	akcb
䓄	aqtr
䓅	airj
䓆	arrj
䓇	afou
䓈	atmc
䓉	aahb
䓊	agkf
䓋	aiqa
䓌	afnu
䓍	ajfj
䓎	aoqy
䓏	agik
䓐	adgn
䓑	aiga
䓒	aqlf
䓓	adtf
䓔	aftb
䓕	afqp
䓖	apwl
䓗	awcn
䓘	athk
䓙	atfx
䓚	ateg
䓛	anbm
䓜	aiqy
䓝	ablf
䓞	aynd
䓟	amfk
䓠	aijf
䓡	atdk
䓢	aldf
䓣	agmy
䓤	aqrn
䓦	amaw
䓧	abkg
䓨	aprm
䓩	asfc
䓪	ajqr
䓫	adsk
䓬	ahjj
䓭	aqsj
䓮	acbt
䓯	agxu
䓰	asff
䓱	ahxs
䓲	awuq
䓳	atve
䓴	admd
䓵	akkk
䓶	agkj
䓷	aith
䓸	avvf
䓹	awye
䓺	augd
䓻	apfv
䓼	avde
䓽	aynb
䓾	aiiv
䓿	aclf
䔀	awtv
䔁	assu
䔂	apuj
䔃	apyg
䔄	aerm
䔅	askk
䔆	aqtf
䔇	amgu
䔈	aamu
䔉	attu
䔊	agua
䔋	axit
䔌	arsg
䔍	acu
䔎	agkp
䔏	atfp
䔐	aiaa
䔑	awtf
䔒	abuk
䔓	aytf
䔔	aujq
䔕	aegy
䔖	abft
䔗	apyd
䔘	armg
䔙	aqqy
䔚	adfe
䔛	axdm
䔜	abmf
䔝	ahxi
䔞	ayxf
䔟	atqq
䔠	asie
䔡	aqou
䔢	awwn
䔣	atjh
䔤	ardj
䔥	avoj
䔦	astu
䔧	atjs
䔨	axty
䔩	agkt
䔪	adqq
䔫	anhi
䔬	alaw
䔭	apne
䔮	aadr
䔯	asgd
䔰	apgl
䔱	arkb
䔲	awgu
䔳	aqdo
䔴	abmc
䔵	ausu
䔶	arjh
䔷	aggn
䔸	addd
䔹	abue
䔺	abde
䔻	aybt
䔼	avyh
䔽	aijn
䔾	arjn
䔿	ausf
䕀	affw
䕁	adjs
䕂	ackp
䕃	abwd
䕄	abil
䕅	avvc
䕆	aswj
䕇	ayrc
䕈	anhs
䕉	alff
䕊	aylg
䕋	afyk
䕌	atwy
䕍	ayek
䕎	ahgl
䕏	augt
䕐	apyl
䕑	axev
䕒	afkk
䕓	apwi
䕔	atqh
䕕	aijc
䕖	abtp
䕗	athj
䕘	awym
䕙	afay
䕚	aakm
䕛	aydw
䕜	anyf
䕝	atef
䕞	auye
䕟	awfw
䕠	aywc
䕡	aukk
䕢	adua
䕣	apun
䕤	akkb
䕥	awwq
䕦	ayny
䕧	ameq
䕨	aeui
䕩	asdi
䕪	ailf
䕫	ahrt
䕬	axgg
䕭	afwo
䕮	afuo
䕯	asfy
䕰	aotl
䕱	agkm
䕲	ayyi
䕳	axgq
䕴	atwo
䕵	afko
䕶	aywc
䕷	aysi
䕸	alfk
䕹	aywy
䕺	aogc
䕻	agmx
䕼	aaky
䕽	akhj
䕾	akkt
䕿	aako
䖀	akkk
䖁	ajmn
䖂	axyr
䖃	adkk
䖄	aako
䖅	afkw
䖆	asge
䖇	asre
䖙	ahnm
䗟	atdj
䗣	afjj
䘌	aadj
䘍	ajmj
䚆	amdq
䛒	agny
䛗	ahny
䜿	ahnu
䝂	ahnu
䠠	aqph
䠢	alph
䡗	amyl
䢡	ansp
䢹	anbh
䢻	ahnb
䢼	awbh
䢽	awkc
䣐	amdb
䣟	aqab
䧿	ajwy
䩐	aftn
䩑	afxn
䩒	afgf
䩓	afqc
䩔	afmc
䩕	afqb
䩖	afit
䩗	afeg
䩘	afgx
䩙	afyx
䩚	afqy
䩛	afnt
䩜	afmg
䩝	afry
䩞	afhk
䩟	afgw
䩠	aftp
䩡	afdw
䩢	afrr
䩣	afwt
䩤	afhq
䩥	aftp
䩧	afyg
䩨	afde
䩩	afpb
䩪	afpn
䩫	afgy
䩬	afdh
䩭	afdk
䩮	afvi
䩯	afbg
䩰	afkb
䩱	afwj
䩲	afyc
䩳	afpc
䩴	afde
䩵	afpl
䩶	afbj
䩷	afuy
䩸	afab
䩹	afgh
䩺	afwn
䩻	afcy
䩼	aftp
䩽	afak
䩾	afyo
䩿	affm
䪀	afpn
䪁	afoy
䪂	afgi
䪃	afyt
䪄	afaw
䪅	aflj
䪆	afmu
䪇	afaf
䪈	afkp
䪉	afvn
䪊	afud
䪋	afkp
䪌	afqy
䪍	afui
䪎	afmk
䪵	ahtm
䫏	adwm
䫖	adwm
䫬	aqam
䬥	awye
䭆	ahne
䰥	akgc
䲨	awvo
䲺	afwo
䲾	agno
䳍	awwo
䳢	adwo
䳬	afwo
䴏	auko
䵋	amwe
䵌	amww
䵍	amwb
䵎	amwj
䵏	amwe
䵐	amwf
䵖	ahni
㔌	bctj
㔎	btwv
㔘	bmln
㔾	bnn
㜾	bwjh
㜿	bcbh
㝂	brrh
㝃	bqkq
㝆	bfkk
㞊	bmfn
㞢	bhgd
㞣	bhwv
㞷	bhgf
㞼	bimj
㤵	btnu
㪿	btbr
㯐	bdas
㱁	bmfw
㱌	bbbw
㷅	bcou
㷦	boou
䃧	btgd
䄐	bmfn
䎲	bnn
䎳	beg
䎴	bfjh
䎵	bntt
䎶	bjhh
䎷	briy
䎸	bgkg
䎺	brmj
䎻	bmfk
䎼	bviy
䎽	bqaj
䎾	bwga
䎿	btoy
䏀	bgkj
䏁	bpuh
䏂	bvhc
䏃	bpju
䏄	bpwf
䏅	bwfi
䏆	bgmj
䏇	bsfi
䏈	bxxi
䏉	bjxo
䏊	bued
䖎	bham
䖓	bmhm
䜐	bday
䢊	bpd
䢫	bdap
䢺	bmbh
䦹	bfh
䦺	bsh
䦻	bbg
䦼	bnwy
䦽	bcbh
䦿	bkhh
䧀	bdcy
䧁	bqkg
䧂	bvkg
䧃	blg
䧄	btkg
䧅	bgxw
䧆	bawy
䧇	byey
䧈	bsg
䧉	bjfg
䧊	btfk
䧋	bhqn
䧌	bevg
䧍	bwwk
䧎	bkeg
䧏	btdh
䧐	bybg
䧑	bpgh
䧒	bsww
䧓	bmfk
䧔	bwyn
䧕	bakg
䧖	baat
䧗	btjt
䧘	bxey
䧙	bmwn
䧚	bymk
䧛	bupy
䧜	byvk
䧝	bbhj
䧞	bcy
䧟	bevg
䧠	bgjf
䧡	byvh
䧢	bakk
䧣	bsfi
䧤	bogy
䧥	bgjn
䧦	beto
䧧	bugt
䧨	bogw
䧩	bnbt
䧪	bydv
䧫	bype
䧬	bpgm
䧭	btln
䧮	bpdn
䧯	bqky
䧰	bqoi
䪼	bmdm
䳳	bmfo
䶹	bte
㐨	cbcb
㓄	cccq
㕕	ccu
㕖	cccs
㕘	ccci
㕙	cwty
㕚	cui
㕛	ccu
㜈	cbtv
㡔	cbth
㣍	cket
㥤	cbtn
㦷	ceat
㪌	cehc
㮗	cbts
㯩	cccw
㰧	ckqw
㷱	cefo
㼧	cegn
䂆	cbty
䂇	cbtf
䂈	cbtj
䂉	cbtd
䂊	cbte
䂌	cbtf
䂍	cbti
䂎	cbtm
䋷	cbti
䏍	cef
䏻	cefc
䖥	cbtj
䘅	cexj
䜼	cbtu
䢄	ckus
䣕	cbh
䣖	ckcn
䥐	cbtq
䨁	cbty
䪻	cadm
䫎	cccm
䫩	cccm
䭴	cfj
䭵	cmyy
䭶	cgjh
䭷	ctfn
䭸	cwqy
䭹	cqbh
䭺	cymn
䭻	cwvn
䭼	cfjh
䭽	crhh
䭾	cdy
䭿	crwy
䮀	cqnn
䮁	ccah
䮂	cdcy
䮃	cfcy
䮄	cyxy
䮅	cant
䮆	cgif
䮇	cvfh
䮈	cqqy
䮉	ctey
䮊	cgxw
䮋	cgqj
䮌	cwsy
䮍	cyeu
䮎	cqdh
䮏	cgkg
䮐	cmwk
䮑	cefy
䮒	cgey
䮓	chjh
䮔	ctgf
䮕	cccc
䮖	cjjg
䮗	cmdf
䮘	cvqn
䮙	cakg
䮚	cfwt
䮛	cbwf
䮜	cans
䮝	cplh
䮞	cdwj
䮟	cpoc
䮠	cgkl
䮡	ctjt
䮢	ctfv
䮣	cccs
䮤	cpwy
䮥	cgkh
䮦	cymk
䮨	cpuh
䮩	cmeg
䮪	cqas
䮫	clvg
䮬	cajd
䮭	cehq
䮮	cswt
䮯	cgqt
䮰	cumd
䮱	cepy
䮲	camw
䮳	ctol
䮴	cwgu
䮵	cujf
䮶	cwys
䮷	clqj
䮹	chdt
䮺	cyjg
䮻	cfnf
䮼	cooh
䮽	cyno
䮾	cued
䮿	cpfh
䯀	cbbb
䯁	cyny
䯂	cccs
䯃	cpvg
䯄	ckmw
䯅	cbcc
䱯	cbto
䳌	cewo
䳱	cbto
㐟	djdn
㓞	dhvn
㓦	djjh
㓨	dwwj
㓫	dgaj
㓴	dmjj
㓶	dhvj
㓹	dooj
㔏	dddj
㔫	dxb
㕂	dwyn
㕃	dgak
㕄	dgxi
㕅	dlk
㕆	ddd
㕇	dud
㕈	dyei
㕉	dwgk
㕊	dgey
㕋	dqd
㕌	djgf
㕍	dwyd
㕎	dfcl
㕏	dgkf
㕐	dvqo
㕑	dfkf
㕒	dugt
㕓	dlff
㕔	dbgn
㕝	dcu
㖛	dkxb
㗉	dhvk
㗤	dhik
㚎	dbj
㚏	daj
㚐	ddu
㚒	dtyy
㚓	dsu
㚔	dufj
㚕	dxjj
㚗	degf
㚚	dqkf
㚛	dxjf
㚜	dakg
㚝	dwff
㚞	dssu
㚠	dugo
㚡	dskk
㛃	dhvv
㝼	dngf
㝽	dnii
㝾	dnda
㝿	dnhc
㞀	dndo
㞁	dnjx
㞂	dnev
㞄	dndn
㞅	dnjs
㞆	dndk
㞇	dnle
㞈	dnya
㞉	dnua
㞝	dhin
㞭	dmj
㣏	djet
㤗	dwnu
㤫	denu
㤲	dwwn
㥑	depn
㥣	dffn
㥻	dtnn
㦮	dnyt
㦮	dxyi
㦺	dfea
㦼	dwva
㦽	deav
㪎	dwwc
㪑	djnc
㪶	djuf
㪺	dhhf
㫪	dwhj
㫳	dfej
㬼	dett
㭐	dgsu
㰭	dfnw
㰮	dfew
㰰	dwww
㰹	dgkw
㱊	depw
㱘	djeh
㲀	dfec
㶫	duou
㷳	dwwo
㷴	dtto
㸴	drhj
㸷	dhvh
㹃	djdh
㹜	ddy
㻎	dggd
㻗	djdy
㻹	degy
㻺	dtty
㼋	drcy
㼍	diry
㼣	djgn
㼤	dhvn
㼩	dnnn
㼪	dwwn
㼲	dmjn
㼽	dqqn
㽁	dttn
㿲	dskc
㿴	dbhc
䀁	delf
䀇	drml
䀾	dchf
䂋	dahs
䂖	dyi
䂗	dxn
䂘	dcyy
䂙	dbh
䂚	dqqy
䂛	dcbh
䂜	ddhh
䂝	dat
䂞	dsu
䂠	dtdy
䂡	drgg
䂢	dtuy
䂣	dhxn
䂤	dwfy
䂥	dnan
䂦	dwet
䂧	dqiy
䂨	dryy
䂩	dldy
䂪	diqn
䂫	dtah
䂭	duqy
䂮	dhvd
䂯	dyfg
䂰	dtjh
䂱	dukq
䂳	dwwf
䂴	dyg
䂵	damy
䂶	dfcl
䂷	dtfx
䂸	dakg
䂹	dqoy
䂺	djsy
䂻	ddey
䂼	dwyn
䂽	dhjh
䂾	dsww
䂿	dijg
䃀	dgvv
䃁	dgfg
䃂	djxx
䃃	dmun
䃄	dyiy
䃅	dujf
䃆	dadw
䃇	drmh
䃈	dxxr
䃉	dnaj
䃊	daeg
䃋	dwgj
䃌	dsfg
䃍	duey
䃎	ddqq
䃏	djtg
䃐	dpwd
䃑	dtec
䃒	dgkh
䃓	dfjf
䃔	dpkk
䃖	dwno
䃗	dvij
䃘	dahf
䃙	dynx
䃚	dytd
䃛	dlpy
䃝	dftt
䃟	daet
䃠	dyth
䃡	daqj
䃢	dqqw
䃣	deto
䃤	dvfj
䃥	dujf
䃨	dxkj
䃩	dmae
䃪	dylg
䃫	dqdy
䃬	dmrc
䃭	ddgn
䃮	dfup
䃯	dris
䃰	dpwi
䃱	dfag
䃲	dtel
䃳	dvln
䃴	dyfj
䃵	dyce
䃶	dyle
䃷	dyny
䃸	dwwg
䃹	dugi
䃺	dysd
䃻	dfae
䆐	dwtt
䊙	dgao
䌠	dgki
䎁	dng
䎡	dmjo
䎢	ditn
䎣	dinw
䎤	dink
䎥	diwk
䎦	dioo
䎧	diuk
䎨	didn
䎩	divl
䎪	dijf
䎫	diqt
䎬	dilc
䎭	ditp
䎮	diud
䎯	diaw
䎰	diar
䎱	dilx
䙽	duhq
䚉	dhvq
䚎	dwvq
䛚	dhvy
䢈	dfej
䢕	dgnp
䣂	dibh
䣅	dfeb
䣍	djnb
䣑	djfb
䣢	diab
䦇	dwnn
䦈	ddag
䦉	dlg
䦊	dhiy
䦋	dgqt
䧸	dwyg
䧺	dkwy
䨅	dujy
䨽	djdn
䩀	djdm
䩁	djdn
䩂	dmjn
䩃	dmjx
䩄	dmjq
䩅	dmjc
䩆	dmjf
䩇	dmjk
䩈	dmju
䩉	dmjy
䩊	dmjb
䩋	dmjs
䩌	dmjo
䩍	dmji
䩎	dmjw
䩏	dmjt
䪤	djdl
䪾	dmwe
䫃	dfem
䫆	dnnm
䫍	djdm
䫑	dskm
䫔	dhvm
䫪	dqqm
䫰	dmoh
䫱	dmjm
䫲	dgkm
䫺	dcmj
䭌	dewe
䭮	deuh
䯭	decu
䯮	deer
䯯	deit
䯰	dewj
䯱	degi
䯲	decb
䯳	dewc
䯴	demc
䯵	defa
䯶	deeg
䯷	dead
䯸	deuw
䯹	devc
䯺	deqk
䯻	detk
䯼	deqo
䯽	deuk
䯾	demk
䯿	deyf
䰀	detv
䰁	devi
䰂	dees
䰃	deug
䰄	deln
䰅	dedm
䰆	decs
䰇	defj
䰈	deua
䰉	detc
䰊	degf
䰋	dejv
䰌	deth
䰍	desi
䰎	dekm
䰏	defy
䰐	deal
䰑	defj
䰒	deae
䰓	dety
䰔	detl
䰕	dehl
䰖	detm
䰭	dmjc
䲪	dwvo
䲽	dwvo
䳊	dcwo
䳑	dewo
䳞	dwfo
䶠	dgkb
䶭	dxgd
䶮	dxgd
㐍	enb
㐠	ebnn
㔜	ebln
㚉	eqqu
㤂	eynu
㥯	eavn
㦝	eern
㦟	eejn
㬳	etfh
㬴	eawy
㬵	euqy
㬶	etfk
㬷	elsy
㬸	eawx
㬹	eqvh
㬺	eudh
㬻	eayq
㬽	ekkn
㬿	eybt
㭀	etaw
㭆	egsu
㰿	exdw
㲕	eftn
㲗	ebtn
㸒	etff
㸓	ejf
㼏	evry
㽰	eenh
䀃	elf
䇓	edmu
䍃	ermj
䏎	emyy
䏏	egfh
䏐	enwy
䏒	ethn
䏓	efqn
䏔	enfg
䏕	etfg
䏖	exhh
䏗	ernn
䏘	eaqn
䏙	epqn
䏚	eitt
䏛	equg
䏜	eeyy
䏝	efny
䏞	egsy
䏟	entt
䏠	eug
䏡	efiy
䏢	ehcy
䏣	eegg
䏤	engk
䏥	emfg
䏦	etdg
䏧	eqqy
䏨	ewnn
䏩	ewgk
䏪	ebg
䏫	ewsy
䏬	ecrh
䏭	eriy
䏮	eliy
䏯	efny
䏰	evyn
䏱	ennk
䏲	euxt
䏳	errh
䏴	eieg
䏵	edne
䏶	exxf
䏷	ejfh
䏸	egkg
䏹	ehqn
䏺	etdh
䏼	eaat
䏽	eukg
䏾	edwh
䐀	edsk
䐁	eeyy
䐂	eviy
䐃	elty
䐄	eqvg
䐅	entd
䐆	eesy
䐇	eqrj
䐈	efhg
䐉	evlg
䐊	ejxx
䐋	ewcn
䐍	efku
䐎	ejgh
䐏	edwj
䐐	etoy
䐑	eans
䐒	edqq
䐓	edmy
䐔	eyna
䐕	ekbg
䐖	enoy
䐗	eftj
䐘	eefc
䐙	eafh
䐚	evcb
䐛	edbg
䐜	efhw
䐝	eimy
䐞	exuu
䐟	efjf
䐠	eayq
䐢	eqbt
䐣	ekmy
䐤	euda
䐥	ewcn
䐦	efcl
䐧	eymk
䐩	emgu
䐪	ewye
䐫	etwh
䐬	egmj
䐭	eaqh
䐮	eutg
䐯	elxi
䐰	ewhe
䐱	eumd
䐲	enrg
䐳	eqoy
䐵	eamw
䐶	eaqj
䐷	ekkf
䐸	evfg
䐹	evfj
䐺	esjh
䐻	eduh
䐼	edhi
䐽	eamy
䐾	elff
䐿	etmd
䑀	enku
䑂	ewfw
䑃	eape
䑄	ethj
䑅	ealq
䑆	eude
䑇	errm
䑈	exrs
䑉	eyny
䑊	ekhp
䑋	eyke
䑌	eugi
䑍	emmv
䑎	ewwg
䑏	eaky
䑟	epqg
䝅	efg
䝈	ergb
䝊	egvh
䝋	epfi
䝌	eccc
䝍	eplh
䝎	emdj
䝏	elvg
䝐	ebde
䝑	eujf
䝒	ebci
䝓	evln
䝔	eaky
䝕	ebbb
䝖	eery
䝗	eesy
䝘	eemc
䝙	eeaq
䝚	eenx
䝛	eehc
䝜	eect
䝝	eedk
䝞	eehm
䝟	eedd
䝠	eedi
䝡	eeay
䝢	eejc
䝣	eeis
䝤	eedi
䝥	eetf
䝦	eeti
䢐	egpd
䢬	epqp
䢸	egbh
䣋	esbh
䤚	ejfg
䪶	egdm
䫇	emfm
䫉	eedm
䫠	egim
䫣	exdm
䲢	eudg
䲯	eywo
䳕	ebwo
䳮	eyno
䴄	epqo
䶺	emwy
䶻	epqn
䶼	ewcn
䶽	eqbt
㐊	fnb
㐋	fnb
㐖	fknn
㐗	ftxn
㐜	fiyv
㐩	fjfj
㒬	fqgd
㒮	fqei
㒹	fhww
㓝	fjjh
㓤	fkjh
㔛	fklb
㔹	fln
㔺	fafj
㖈	ftxk
㖝	fikx
㗯	ftjx
㘦	fln
㘧	fcbh
㘨	fmwy
㘩	fxxn
㘪	ftfn
㘫	ffjh
㘬	fqcy
㘭	fxnn
㘮	fnyy
㘯	ftln
㘰	fufh
㘱	fmfg
㘲	fnvn
㘵	fdmh
㘷	faqy
㘺	fwat
㘻	fldy
㘼	fftn
㘽	fafd
㘾	fpgf
㘿	fjfg
㙀	fpwv
㙁	ftxu
㙂	fukq
㙃	frgw
㙄	fxxf
㙅	fksy
㙆	fpdc
㙇	feyy
㙈	fham
㙉	fmaw
㙊	fdey
㙋	fadw
㙌	fvij
㙍	fccc
㙎	fdgt
㙏	ftjt
㙐	fmdj
㙓	ffff
㙔	fnhh
㙕	fleg
㙖	ftky
㙗	flge
㙘	fsvg
㙚	fugh
㙛	fgef
㙝	flle
㙞	fths
㙟	fyve
㙡	ftwh
㙢	famy
㙣	fxde
㙤	fhah
㙥	fuke
㙧	fgal
㙨	fxxt
㙩	fdui
㙪	ffpu
㙫	fwys
㙭	fduw
㙮	ftwk
㙯	fwfc
㙲	fyxy
㙳	fdgn
㙴	fqdy
㙵	fymf
㙷	fjxo
㙸	fwoy
㙹	falq
㙺	fakm
㙻	fyjf
㙼	flll
㙽	fddj
㙾	fwfb
㙿	fugt
㚀	fhaa
㚁	fffq
㚂	fgke
㚃	fpqu
㚄	fplh
㚘	fwfw
㜂	fffv
㜌	fpgc
㝅	fpgc
㝴	fqfi
㠻	ftmh
㢤	faqv
㣋	fjye
㥁	flnn
㥲	fhwn
㦞	fnan
㦤	fpgn
㦲	faqv
㦳	fafd
㨌	fprc
㨍	fffr
㪈	ffhc
㪍	fpbt
㪮	fkkc
㪴	fquf
㫄	fqyb
㫩	fajf
㯏	fnms
㰦	fcqw
㰪	ffqw
㰻	fkuw
㱅	fpgw
㱇	fwww
㱋	fwyw
㱏	fhf
㱐	fhyi
㱿	fmgc
㲄	fpgc
㲆	fnmc
㲇	fnmu
㲈	fnmk
㲉	fpgc
㲍	fctn
㲠	fitn
㲦	fjwn
㶣	fou
㷤	fpgc
㷫	fnmo
㹈	fith
㹕	fqdh
㺉	fpgc
㼥	ftgn
㼬	fufn
㼭	fhkn
㽌	fqyn
㿦	fnmr
㿻	flf
䀋	fthl
䂲	fcld
䅽	fnmt
䍍	fpgc
䎐	fjng
䎛	ftxk
䎜	ftxx
䎝	ftxn
䎞	ftjn
䐨	fpgc
䖔	fchm
䖯	ffju
䘁	fawj
䘄	ftjj
䘮	fwwe
䙿	fihq
䚂	fohq
䚖	fkkq
䞇	fwfm
䞑	foag
䞒	fomk
䞓	foga
䞔	fonn
䞕	fofj
䞖	fhai
䞗	fhft
䞘	fhtn
䞙	fhgh
䞚	fhfc
䞛	fhgn
䞜	fhgi
䞝	fhgy
䞞	fhxj
䞟	fhrd
䞠	fhdd
䞡	fhjg
䞢	fhtf
䞣	fhry
䞤	fhqk
䞥	fhde
䞦	fhtk
䞧	fhrk
䞨	fhff
䞩	fhwk
䞪	fhar
䞫	fhvk
䞬	fhte
䞭	fhct
䞮	fhwt
䞯	fheb
䞰	fhfo
䞱	fhwk
䞲	fhtt
䞳	fhuk
䞴	fhmk
䞵	fhcc
䞶	fhjr
䞷	fhnm
䞸	fhfk
䞹	fhrg
䞺	fhrh
䞻	fhcl
䞼	fhxe
䞽	fhfi
䞾	fhrm
䟀	fhua
䟁	fhvs
䟂	fhjc
䟃	fhce
䟄	fhgm
䟆	fhjf
䟇	fhxt
䟈	fhfg
䟉	fhlj
䟊	fhhe
䟋	fhqy
䟌	fhfy
䟍	fhty
䟎	fhfm
䟏	fhxs
䟐	fhdh
䟑	fhwa
䟒	fhay
䠟	fufh
䡤	ftjl
䡰	fnml
䢮	flpd
䢱	flmp
䢵	fcbh
䣇	fiyb
䣠	fwfb
䤰	fqwq
䥅	fggq
䥍	fufq
䥢	fkuq
䥭	fiyq
䧲	fwyg
䧴	fcwy
䨋	ftab
䨌	ffqb
䨍	ffjj
䨎	fxcu
䨏	fuqw
䨐	fwgk
䨑	fgxw
䨒	fnf
䨓	flkf
䨔	fiqb
䨕	figf
䨖	fdef
䨗	febf
䨘	fhqb
䨙	fitf
䨚	fqrn
䨛	fsrj
䨜	feef
䨝	fgef
䨞	ftky
䨟	fiff
䨠	fjqn
䨡	fbib
䨢	fadn
䨣	fafj
䨤	fmpu
䨥	fwyc
䨦	fupy
䨧	fuwc
䨨	fwnp
䨩	fpyh
䨪	ffjf
䨫	fswt
䨬	fiss
䨭	ffce
䨮	fdhv
䨯	fbgi
䨰	fiaf
䨱	fttt
䨲	fdmy
䨳	fhqq
䨴	fogf
䨵	fisj
䨶	fchn
䨷	fssc
䨸	fben
䨹	fwho
䨺	ffcc
䨻	flfl
䪺	fcdm
䫙	fasm
䫦	fclm
䬠	fnuh
䬡	ftjh
䮧	fjwc
䰟	fcrc
䰩	ftjc
䰰	fdmc
䰱	fkkc
䲀	fufo
䲧	fwvo
䲮	fqwo
䲰	fcwo
䲶	fqwo
䳏	ffwo
䳒	fawo
䳓	ftxo
䳣	faqo
䴃	fffo
䴅	famo
䴇	fwyo
䴒	fkko
䵧	falo
䵷	ffxg
䵺	fhnn
䵽	fkuc
䵿	fkuk
䶀	fkuk
䶁	fkuj
䶬	ffud
㐀	gjgg
㐁	gkwi
㐏	gnb
㐙	gkun
㐚	gknb
㒫	ghfq
㓰	gmbj
㔝	gmhl
㔻	gifj
㔿	gnhk
㘸	gqxf
㝳	gni
㠪	ghd
㡂	gqjh
㤁	gdnu
㤠	gqjn
㤪	gqbn
㥿	gqtn
㦱	gafd
㩽	gkic
㪀	gfty
㪅	gmwc
㪝	glic
㪪	gddc
㪷	gkuf
㪽	gjrj
㫘	gijf
㬜	gcfj
㬲	gjql
㯥	gjii
㯱	gkhs
㯻	gkhs
㰆	gkhs
㰢	gaqw
㰯	gkuw
㰳	gfgw
㰷	gqxw
㱙	gqgn
㱚	gqeg
㱛	gqgq
㱜	gqhy
㱝	gqxl
㱞	gqug
㱟	gqhc
㱠	gqdg
㱡	gqtq
㱢	gqye
㱣	gqev
㱤	gqsr
㱥	gqft
㱦	gqdk
㱧	gqpb
㱨	gqph
㱩	gqfd
㱪	gqnj
㱫	gqgi
㱬	gqle
㱭	gqwc
㱮	gqkm
㱯	gqmu
㱰	gqpu
㱱	gqrc
㱲	gqul
㱴	gqgm
㱵	gqfm
㱶	gqfe
㱷	gqws
㱸	gqnu
㱹	gqdh
㱺	gqhl
㱻	gqyy
㶨	giou
㶪	giou
㶮	gmwo
㺨	gcy
㺩	gnhh
㺪	ghy
㺫	gjh
㺬	gmyy
㺭	gbg
㺮	gfnn
㺯	gdu
㺰	ggmh
㺲	gnfg
㺳	ghcy
㺴	gdy
㺵	gqwy
㺶	gufh
㺷	gsyy
㺹	gcah
㺺	ghg
㺻	ggmh
㺼	gnhy
㺽	ggig
㺾	gmkg
㺿	gahh
㻀	gjqy
㻁	glkg
㻂	guah
㻄	gtgh
㻅	gwfc
㻆	gceg
㻇	gwgg
㻈	grgk
㻉	ghit
㻊	gqkq
㻋	ggki
㻌	gwty
㻍	gkgd
㻏	gvoy
㻐	gcwt
㻑	gtbg
㻒	glty
㻓	gbcy
㻔	gtgf
㻕	gnbm
㻖	gviy
㻘	gpjh
㻙	gyce
㻚	geeg
㻛	gjqr
㻜	gwwh
㻝	ggkj
㻞	gyna
㻟	gdae
㻠	gpwd
㻡	gans
㻢	gytb
㻣	gadn
㻤	gaqk
㻥	gusg
㻦	gjmy
㻧	gqas
㻩	guvo
㻪	gwye
㻫	gjaf
㻬	gffn
㻭	gyxf
㻮	gwfi
㻯	ghah
㻰	gdhv
㻱	gtdp
㻲	glvg
㻳	gatj
㻴	gjlc
㻵	gnbb
㻶	gtvh
㻷	ggmi
㻸	gaqj
㻻	gybt
㻼	gsjh
㻽	gwym
㻿	glqj
㼀	gfup
㼁	gugt
㼃	gvln
㼄	gxxl
㼅	gyaw
㼆	gooy
㼇	gmwm
㼈	glxy
㼊	gbny
㼑	gliy
㼛	gagn
㼞	guhn
㼮	gvhn
㼯	gjin
㽝	gqjl
㽬	gkll
㿼	galf
䋤	gxiy
䍾	gang
䑒	gcfy
䗞	gdjj
䘉	gdjj
䙹	gahq
䚍	gmhq
䚕	gmyq
䜳	gkun
䜴	gkuc
䜵	gkuc
䜶	gkuh
䜷	gkuc
䜸	gkun
䜹	gkui
䜺	gkuj
䜻	gkuh
䜽	gkuj
䜾	gkuj
䝀	gkul
䝃	gkuo
䝄	gkuc
䝴	gkhm
䝾	gahm
䢋	gjpk
䢌	gmhp
䢎	gapk
䢚	gjqp
䢝	gfgp
䢥	ghhp
䢩	gktp
䣆	gvab
䣓	gkmb
䨼	geac
䨿	gddd
䪞	gddg
䪟	gmhg
䪣	gmhg
䪲	gqdm
䪹	gigm
䫊	gikm
䫨	gqtm
䫷	gkkm
䬩	giwe
䬸	gqce
䰙	gkmc
䰚	gkmy
䰛	gkmn
䰝	gkmj
䰤	gjic
䱫	gkio
䲫	gqwo
䲹	gigo
䴓	gmhg
䴕	gqjg
䴖	geqg
䴡	godx
䵅	gqtt
䵡	gdlo
䵤	galo
䶍	gcfj
䶛	gqjb
㓟	hcjh
㓠	hkjh
㓺	hayj
㔧	hall
㔽	hlkf
㕟	hmac
㕡	hpgc
㕢	hpgc
㘹	hxff
㛑	hqcv
㠿	hxmh
㢟	hpd
㣌	hket
㣓	hqce
㤐	hknu
㦸	hjat
㧘	hxrj
㪕	hjhc
㪥	haec
㪫	hpgc
㪭	halc
㫖	hjf
㫮	hxjf
㭰	hxgi
㮂	hwsu
㮚	hlws
㰣	hxqw
㱆	hagw
㱑	hqu
㱒	hskf
㱓	hwyc
㱔	hxqu
㱕	hvph
㱖	hywf
㱗	hthd
㲃	hjxc
㲊	hpgc
㷡	hano
㿪	hcvy
㿬	hccn
㿳	hcvl
㿵	hcdd
㿸	hcjc
㿹	hcfp
䀎	hgnn
䀐	het
䀑	hcyy
䀒	htfh
䀓	hvyy
䀔	hvyy
䀕	hxhh
䀖	hgdy
䀗	hnwy
䀘	hgah
䀙	havn
䀚	hqbj
䀛	hqrt
䀝	hxxn
䀞	hufh
䀟	hxjh
䀠	hhg
䀡	hhkg
䀢	htdy
䀣	hntt
䀥	hqiy
䀦	hdg
䀧	hawy
䀨	htdg
䀩	htkg
䀪	htfh
䀫	hwgk
䀬	hwgg
䀭	hynw
䀮	hynq
䀯	hgey
䀰	hwwk
䀱	htdh
䀲	htxu
䀳	hgki
䀴	hgva
䀵	hctd
䀶	hyve
䀷	hfcl
䀹	hdww
䀻	hmgn
䀼	hdfe
䀽	hthp
䀿	hrrh
䁀	hrrj
䁁	hyiy
䁃	hgey
䁄	hfuf
䁅	hblg
䁆	hdjn
䁊	hcyh
䁋	hans
䁌	hleg
䁍	hdgt
䁎	hyps
䁏	hsvg
䁐	hamd
䁑	hjgr
䁒	hkbg
䁓	hqbt
䁔	hefc
䁕	hnaj
䁖	hovg
䁗	hmgu
䁘	herm
䁙	hjpv
䁚	hkmy
䁛	hrqc
䁜	hjiq
䁟	huda
䁠	huvo
䁡	huwy
䁢	hyth
䁣	hgjf
䁤	humd
䁥	haak
䁦	hhag
䁧	hakw
䁨	hybb
䁩	hqoy
䁪	hlrh
䁫	hlfo
䁬	hulj
䁭	hddd
䁮	haqj
䁯	hwgn
䁰	hadm
䁱	hffq
䁲	hlmy
䁳	hada
䁴	hylg
䁵	hlge
䁶	hryt
䁸	hmae
䁹	hnku
䁺	hlff
䁻	hxrs
䁼	hlff
䁽	hvln
䁾	halt
䂀	hugt
䂁	hqky
䂂	hhhy
䂃	helf
䂄	hhhc
䂅	hxyj
䋰	hwxi
䖈	haxv
䖉	hagf
䖋	hamw
䖌	hamj
䖍	hati
䖏	haqy
䖑	hamj
䖒	hagu
䖕	hamg
䖖	haml
䖗	hadt
䖘	hamy
䖚	hamo
䖛	hami
䖜	hamj
䖪	hxju
䙷	hqfu
䙸	hqfi
䚃	hlnq
䜭	hpgk
䝳	hqcm
䡞	hwlj
䢲	hhwp
䣜	haeb
䣤	hhwb
䧳	hwyg
䪥	hpgg
䬌	hamj
䰗	hggn
䰘	hgge
䱗	hqco
䱷	haqt
䲣	haqt
䳄	hxwo
䴗	hdqg
䴚	hlom
䴛	hloe
䴜	hloc
䴝	hloc
䴞	hloy
䵻	hndv
䶔	hbbn
䶕	hbcn
䶖	hbwn
䶗	hbsk
䶘	hbug
䶙	hban
䶚	hbjy
䶜	hbtk
䶝	hbdw
䶞	hbaw
䶟	hbqv
䶡	hbmj
䶢	hbdt
䶣	hbmu
䶤	hbme
䶥	hbhg
䶦	hbgm
䶧	hbfq
䶨	hbww
䶩	hbyj
䶪	hbfy
䶫	hbkt
䶶	hrjh
㐢	iebn
㒯	iqaf
㓥	ivjh
㕾	ikxb
㖳	ivkx
㗟	iygx
㗬	ipkq
㙙	idnf
㜑	igev
㝸	irqb
㝹	itqy
㢢	imka
㦂	ipkn
㨇	ihcr
㲂	imkc
㲖	ietn
㲚	iitn
㲸	inn
㲹	imn
㲺	ian
㲼	iqy
㲽	ivyy
㲿	iyt
㳀	iat
㳁	idwy
㳂	iwcy
㳃	ivfh
㳄	iqwy
㳅	igiy
㳆	iufh
㳇	iwqy
㳈	ifqn
㳉	ieg
㳊	ity
㳋	irgg
㳌	ilh
㳍	idmh
㳎	icah
㳏	ikqy
㳐	isnn
㳑	ilg
㳒	idcy
㳓	idkg
㳔	icfy
㳕	iufg
㳖	iyey
㳗	icyf
㳘	iycq
㳙	iceg
㳚	idyt
㳛	ivwy
㳜	iwsy
㳝	iwtf
㳞	iwkh
㳠	idpy
㳡	ifpy
㳢	itdj
㳣	iftx
㳤	iuau
㳥	igah
㳦	iaah
㳧	ibnn
㳨	ivgq
㳩	iamy
㳪	igik
㳫	ivf
㳬	itnh
㳭	iksy
㳮	iniy
㳯	iuh
㳰	iyca
㳱	ibjg
㳲	iidy
㳳	idqn
㳴	intf
㳵	itbg
㳶	iebn
㳷	iqrj
㳸	iawx
㳹	isgg
㳺	irtb
㳻	iajg
㳽	ixti
㳾	iudn
㳿	iycs
㴀	iatp
㴁	igdj
㴂	iamf
㴃	iyni
㴄	ilwm
㴅	ilwk
㴆	ivph
㴇	iiiy
㴈	irgm
㴉	iccf
㴊	iubj
㴋	ivij
㴌	ivdg
㴍	ibdi
㴎	idfi
㴏	ipwg
㴐	ihgn
㴑	iyut
㴒	iyoa
㴓	ilny
㴔	iqvn
㴕	iaty
㴖	iafh
㴗	isvg
㴘	ijhg
㴙	itfv
㴚	iuey
㴛	igct
㴜	iyna
㴞	iehj
㴟	idjb
㴠	ibkb
㴡	itjg
㴢	iiwh
㴣	iigw
㴤	isyg
㴥	imie
㴦	ipkk
㴧	ithn
㴨	ieud
㴩	ivkc
㴪	iths
㴫	ivtb
㴬	itmf
㴭	ipwh
㴮	inie
㴯	iexj
㴰	icex
㴱	ipwu
㴲	irhm
㴳	ifde
㴴	iogn
㴵	intl
㴶	ipwy
㴷	ibpq
㴸	iuwy
㴹	iopy
㴺	iidw
㴻	igkf
㴼	ipwj
㴽	iton
㴾	ifpt
㴿	isdm
㵀	iytd
㵁	iayq
㵂	iyao
㵃	ijpx
㵄	iakd
㵅	iwym
㵆	ijtk
㵇	itdf
㵈	iivd
㵉	iiss
㵊	ijbc
㵋	ilmy
㵌	itrh
㵍	iuny
㵎	iueg
㵏	iayf
㵐	iduw
㵑	ilkm
㵒	ixjm
㵓	ipjh
㵔	idfj
㵕	iccn
㵖	ivki
㵘	iiii
㵙	ifkk
㵚	iwqq
㵛	iudk
㵜	iiff
㵝	iyek
㵞	iton
㵟	itmt
㵠	ipwm
㵡	ifqn
㵢	iflg
㵣	ijqw
㵤	indw
㵥	ipnl
㵦	idap
㵧	iajn
㵩	iaas
㵪	iugw
㵫	ibbj
㵬	ieel
㵭	ifto
㵮	idaf
㵯	imgo
㵰	iwfw
㵱	isff
㵲	irlh
㵳	ipne
㵴	idnt
㵵	ibci
㵶	ifay
㵸	iwga
㵹	imad
㵺	itrf
㵻	ievc
㵼	ipvo
㵽	illl
㵾	igeq
㵿	irrr
㶀	iene
㶁	iefm
㶂	iiaw
㶃	iiro
㶄	iuqv
㶅	iwfb
㶆	iyfj
㶇	isaw
㶈	iooj
㶉	iexg
㶊	iahm
㶋	ioeg
㶌	ibxg
㶍	iqod
㶎	ilgp
㶏	iben
㶐	iywn
㶑	iwgw
㶒	iucy
㶓	iadt
㶔	illd
㶕	ituj
㶖	iwho
㶘	itsj
㶙	iiog
㶚	isae
㶛	iytw
㶜	inuj
㶝	iiyn
㶞	ijye
㶟	illi
㶠	iclf
㸺	iith
㼕	ipky
㼳	ithn
㽆	ipkn
㽏	iwgf
䀀	iblf
䀊	inwl
䆪	iqpa
䚇	ithq
䟫	ipkh
䣉	iitc
䣊	imkb
䣔	imbh
䣘	ipkb
䣣	ipkb
䤔	ilrg
䰪	iwec
䲵	itwo
㒻	jhqb
㒽	judb
㒾	jytb
㒿	jyby
㓭	jqwj
㓳	jghj
㔀	jyij
㔠	jqwl
㝵	jgfu
㦔	jedn
㦹	jgqa
㧛	jtyr
㪋	jfhc
㪙	jsty
㪞	jhhc
㪤	jaft
㫀	jjrh
㫐	jxb
㫑	jln
㫒	jaj
㫓	jtnn
㫔	jhf
㫕	jgqb
㫗	jbf
㫙	jfwy
㫛	jkqn
㫜	jjgg
㫝	jqay
㫞	jbhc
㫟	jmkg
㫠	jufh
㫡	jtuu
㫢	jfcy
㫣	jjnb
㫤	jyni
㫥	jqkg
㫧	jou
㫨	jpvg
㫫	jgog
㫬	jqjg
㫭	jffu
㫯	jjgq
㫰	jyve
㫱	jfou
㫲	jfpb
㫴	jftb
㫵	jdjd
㫶	jvph
㫸	jgvh
㫹	jrnr
㫻	jwga
㫼	jrmj
㫽	jviy
㫾	jimk
㫿	jwyg
㬀	jybg
㬁	jiwk
㬂	jjmy
㬃	jcko
㬄	jdfo
㬅	jldn
㬆	jnaj
㬇	jqmd
㬈	jjlg
㬉	jdmd
㬊	jefc
㬋	jwnd
㬌	jyji
㬍	jgef
㬎	jxxo
㬏	jgkh
㬐	jgoj
㬑	jybb
㬒	jada
㬓	jsfi
㬔	jnwe
㬕	jpyd
㬖	jynk
㬗	jqdo
㬘	jvfj
㬙	jeto
㬚	jyct
㬛	jwgn
㬝	julj
㬞	jmjn
㬠	jqvo
㬡	jfwc
㬢	jugt
㬣	jogf
㬤	jjxo
㬥	jbmo
㬦	jawc
㬧	jbmi
㬨	jfoo
㬩	jdhn
㬪	jjjg
㬬	jhhy
㬭	jelf
㬮	jaky
㬯	jyny
㬰	jwi
㰩	jqwy
㷖	jovk
㼔	jlry
㼫	jsgn
㼴	jmhn
㼵	jghn
㿢	jerf
㿺	jawc
䖞	jfy
䖠	jmyy
䖡	jnfg
䖢	jitt
䖣	jrhy
䖦	jbmh
䖧	jjgg
䖨	jdg
䖩	jntt
䖫	jwfh
䖬	jlh
䖮	jtmk
䖰	jrey
䖱	jagg
䖲	jqjg
䖳	jpta
䖴	jiqn
䖵	jjy
䖶	jey
䖷	jqdh
䖹	jgjf
䖻	jycq
䖼	jfcb
䖾	jpfq
䗀	jfwt
䗁	jdsk
䗂	jham
䗃	jaat
䗄	jwqr
䗅	jdey
䗆	jpnn
䗇	jqoy
䗈	jynh
䗉	jjjg
䗊	jooy
䗋	jafs
䗌	jjtg
䗎	jsfg
䗏	jpoc
䗑	jjug
䗒	juog
䗓	jqrn
䗔	jwnd
䗖	jgkh
䗗	jtga
䗘	jfcl
䗚	jgef
䗛	jwhe
䗜	jqyl
䗡	jgho
䗢	jtfp
䗤	jyvh
䗥	jtwh
䗦	jtdp
䗧	jyvi
䗨	jqoy
䗩	jdht
䗫	jyss
䗭	jkkn
䗮	jdqq
䗯	jwyp
䗰	jxfm
䗱	jogy
䗲	joqh
䗳	jwgu
䗴	jttp
䗵	jglg
䗶	jajn
䗷	jujn
䗹	juxn
䗻	jtvb
䗼	jtgo
䗾	jjxo
䗿	jpns
䘂	jfag
䘃	jlff
䘆	jpdn
䘈	jdal
䘊	jtlt
䘋	jwwg
䘎	jxyx
䛓	jtyy
䝨	jcmu
䨃	jpvy
䫘	jqwm
䬗	jgqj
䯫	jyik
䳋	jwvo
䳚	jfwo
䳛	jvwo
䳟	jewo
㒭	kqkq
㓵	kkfj
㕜	khcu
㕤	kvn
㕥	kwy
㕦	kdu
㕧	knt
㕨	kmyy
㕩	kdhh
㕪	kpqn
㕫	kyn
㕬	kwcy
㕭	ktdy
㕮	kwqy
㕰	ktfn
㕱	kdnn
㕲	ksy
㕳	kqbh
㕴	kpmn
㕵	kgg
㕶	kgg
㕷	krg
㕸	kug
㕹	kdcy
㕺	kkgn
㕼	kqqn
㕽	knyw
㖀	kvfh
㖁	kqdc
㖂	kjxt
㖃	krgk
㖄	kyth
㖅	kdgt
㖆	kmag
㖇	kdmj
㖉	kwhg
㖊	kvfy
㖎	kxwj
㖏	kjfg
㖐	kkvt
㖑	kaah
㖒	kuxt
㖓	ktdh
㖔	kgdk
㖕	kuh
㖗	kmwn
㖘	kdfe
㖞	kkmw
㖟	kepc
㖠	kdfi
㖡	kywy
㖢	kyhx
㖣	kukg
㖤	kbib
㖥	klty
㖦	kgji
㖧	kqaj
㖨	kviy
㖩	kbcy
㖪	kakg
㖫	kfwt
㖬	kvcy
㖭	kgdn
㖮	kwga
㖰	kxmk
㖴	kaqr
㖵	khwy
㖶	ksfg
㖷	kjgh
㖸	khag
㖹	kwvl
㖺	kdwj
㖻	kcbs
㖼	kafs
㖽	kdmy
㖾	kkut
㖿	kbbh
㗀	kxxm
㗁	kkkn
㗂	kith
㗃	knaj
㗄	klyn
㗅	kdeg
㗆	kafh
㗇	knhc
㗈	kcel
㗊	kkkk
㗋	kqdd
㗌	kpgf
㗍	ktjg
㗎	klks
㗏	kgih
㗐	kdyl
㗑	krdf
㗒	kyey
㗓	kwnp
㗔	khay
㗕	kfjf
㗖	kevg
㗗	klrf
㗘	kgef
㗙	kqbt
㗚	kssy
㗛	kttd
㗜	kyxl
㗝	kugo
㗞	kdhc
㗢	ktgl
㗣	kaqh
㗥	kybb
㗦	kbqb
㗧	kpwf
㗩	knrg
㗪	khxi
㗫	kwfi
㗭	kton
㗰	ktwh
㗱	kwys
㗲	kvfg
㗳	ktwk
㗴	kueg
㗵	koow
㗶	kwxc
㗷	kpfm
㗸	ktrh
㗹	kwyn
㗺	kgdd
㗻	kmnp
㗼	kogw
㗾	kafx
㗿	kusk
㘀	kvoy
㘁	klff
㘂	kuxn
㘃	kadn
㘄	ksly
㘅	ktqh
㘆	kfkf
㘇	koos
㘈	kxth
㘉	ktvb
㘊	kfyg
㘋	kahm
㘌	khaj
㘍	kiwa
㘎	kunt
㘐	kcuq
㘑	kffi
㘓	kugi
㘔	kpfm
㘕	kaal
㘖	kutm
㘗	khhy
㘙	kkkt
㘚	kunt
㘛	kwgd
㘴	kwff
㙱	kgnf
㰨	kwqw
㽞	kklf
䑝	kkph
䚋	kmhq
䟓	khsh
䟔	khhy
䟕	khcy
䟖	khmh
䟗	khqa
䟘	khym
䟙	khav
䟚	khfj
䟛	khgh
䟜	khmw
䟝	khmc
䟞	khit
䟠	khat
䟡	khqy
䟢	khqi
䟣	khsy
䟤	khnt
䟥	khct
䟦	khtc
䟧	khlg
䟨	khna
䟩	khfc
䟪	khtp
䟬	khrg
䟭	khtf
䟮	khwd
䟯	khtd
䟰	khth
䟱	khgi
䟲	khyq
䟳	khnd
䟴	khde
䟵	khfy
䟶	khwf
䟷	khrr
䟸	khqa
䟹	khef
䟺	khmy
䟻	khwt
䟼	khgh
䟽	khyq
䟾	khcc
䟿	khvi
䠀	khik
䠁	khcf
䠃	khgy
䠄	khmw
䠅	khlt
䠆	khde
䠇	khnm
䠈	khvi
䠉	khpn
䠊	khdd
䠋	khrf
䠌	khie
䠍	khnc
䠎	khnf
䠏	khwd
䠐	khhd
䠑	khdf
䠒	khde
䠓	khug
䠔	khue
䠕	khhs
䠖	khuk
䠗	khtd
䠘	khtx
䠙	khuy
䠚	khpy
䠛	khem
䠜	khab
䠝	khkm
䠞	khdt
䠡	khhg
䠣	khnw
䠤	khkf
䠥	khut
䠦	khtj
䠧	khnj
䠨	khqy
䠩	khht
䠪	khxn
䠫	khbi
䠬	khwb
䠭	khgm
䠮	khuc
䠯	khwa
䠰	khay
䠱	khnj
䣈	kckc
䣒	khgb
䣞	kkub
䪽	kgnm
䫟	kmdm
䫭	khgm
䬭	kvwe
䶷	kqn
䶸	ktcy
㐃	lhk
㓻	lghj
㔔	lkkf
㔖	lknb
㔣	llll
㔥	lcel
㖙	lkkx
㘝	lci
㘞	llv
㘟	lak
㘠	lnte
㘡	llk
㘢	liqv
㘣	lked
㘤	lijg
㘥	leri
㙒	lcbf
㚙	lkdu
㚻	lvf
㜞	lrvf
㝶	lqfu
㟻	lrmj
㠰	lknb
㤎	lknu
㤙	lnnu
㦁	lpnu
㧝	lkrj
㨻	lrrj
㨼	ltkr
㪹	lvuf
㱄	lfow
㱎	liqw
㲲	llln
㸃	lfho
㽒	lltg
㽖	lln
㽗	lwy
㽘	lymn
㽙	lcqn
㽚	lrhj
㽛	lqkg
㽟	lefy
㽠	ldww
㽡	lrtf
㽢	ldjn
㽣	lakg
㽤	lqoy
㽥	lcbs
㽧	luxx
㽨	luda
㽩	lcce
㽪	lulj
㽭	lfdj
㽮	lllg
㽯	lmwk
䁿	lfoh
䂟	lkdf
䌎	ltki
䍐	lfj
䍒	lsu
䍓	laht
䍔	ldcu
䍕	lqay
䍖	lqnb
䍗	lyxu
䍘	lou
䍙	ltxu
䍚	lyve
䍛	lldf
䍜	lwyf
䍝	lijf
䍟	lqbt
䍠	lybc
䍡	lynx
䍢	lrlo
䍣	lflf
䍤	lyjf
䍥	ldth
䍦	lyby
䚑	lmhq
䝱	lllm
䟅	lrfh
䡂	lnhh
䡃	lln
䡄	lmn
䡅	lkh
䡆	lwcy
䡇	lfqn
䡈	lqqy
䡉	lymn
䡊	lrcy
䡋	lfcy
䡌	ldcy
䡍	lfwy
䡎	lynt
䡏	lxcy
䡐	lpxn
䡑	lnan
䡒	llg
䡔	lqqy
䡕	lbig
䡖	lgwf
䡘	lqlg
䡙	lyve
䡚	lrqn
䡛	llh
䡜	lfwf
䡝	lpqb
䡟	lrtf
䡠	lhmy
䡡	lxxr
䡢	lyna
䡣	lplh
䡥	lpwk
䡦	lccs
䡧	lwno
䡩	lfhw
䡪	lynn
䡫	ltdp
䡬	ljlc
䡭	ludf
䡮	ltwh
䡯	ltln
䡱	lakk
䡲	lkkf
䡳	ladr
䡴	lujf
䡵	luep
䡶	lnku
䡷	lafl
䡸	lalt
䡹	lfph
䡺	ldhn
䡻	lthy
䡼	lfkk
䡽	ltfm
䡾	lhad
䡿	lfkw
䢀	ltnn
䢁	leg
䢂	lug
䣚	lvbh
䪪	lkuj
䫫	lvdm
䫳	lqjm
䭕	lrwe
䳴	liwo
䳻	lrwo
䴉	lgko
䴎	lllo
䴑	lllo
䵝	lfon
䵞	lfoj
䵟	lfof
䵠	lfoy
䵢	lfoi
䵣	lfog
䵥	lfoc
䵦	lfof
䵨	lfoe
䵪	lfox
䵬	lfoj
䵭	lfoj
䵮	lfor
䵯	lfof
䵰	lfor
䵱	lfok
䵲	lfos
䵳	lfoj
䵴	lfox
㐕	mnb
㒳	mhty
㒷	mwgw
㒺	muwn
㓘	mgqy
㓮	mfkj
㓽	mpfj
㔒	mwyj
㕀	mbb
㕯	mwkd
㖯	mgkx
㞤	mwu
㞥	mtyu
㞦	mmn
㞧	meb
㞨	mbg
㞩	mmyu
㞫	mpu
㞬	maf
㞮	mqyu
㞰	mtfh
㞱	mjf
㞲	mkhh
㞳	mufh
㞴	mqan
㞵	myu
㞶	myy
㞸	mgiu
㞹	mskg
㞺	mtdu
㞻	mkgn
㞽	mant
㞾	mnxn
㞿	mfqu
㟁	mdfh
㟂	mxgu
㟃	mngk
㟄	mudh
㟅	mqbq
㟆	mwxf
㟇	mwwf
㟈	mfiy
㟉	mprh
㟊	mebg
㟋	mukq
㟌	mdne
㟍	myve
㟎	mevg
㟏	mwyk
㟐	mayn
㟑	mfpb
㟒	mvtk
㟓	mqdh
㟔	mwyk
㟕	mkuf
㟖	mgaj
㟘	mmfk
㟙	majg
㟛	mraf
㟜	mxqi
㟝	mukg
㟞	maat
㟟	mawb
㟠	mmum
㟡	mudb
㟢	mdsk
㟣	mswc
㟤	mviu
㟥	mcde
㟦	mplj
㟧	mkkn
㟨	mmdj
㟪	mlge
㟫	mriy
㟬	mvhc
㟭	mnaj
㟮	mpwd
㟯	mptk
㟰	mpju
㟱	mugo
㟲	mdri
㟳	mssy
㟴	mrqc
㟵	mlgh
㟶	mdri
㟷	mawk
㟸	mrdf
㟹	mbqb
㟺	mlvf
㟼	mgqt
㟽	msfi
㟾	myvh
㟿	mada
㠁	mcce
㠂	mgqt
㠃	mumd
㠄	mnrf
㠅	mttt
㠆	mkkf
㠇	myin
㠈	mugg
㠉	mujf
㠊	mhag
㠋	mkkn
㠌	madw
㠍	mwys
㠎	mwys
㠏	magf
㠐	mtdk
㠑	mldd
㠒	msfj
㠓	mape
㠔	mnku
㠕	mbrc
㠖	mugt
㠗	mtmd
㠘	mwfw
㠙	mype
㠚	mogf
㠛	mawc
㠜	mxth
㠝	mfwm
㠟	mtqi
㠠	mhal
㠡	myce
㠢	mrqe
㠣	mdth
㠤	myke
㠥	mllf
㠦	mdhu
㠧	mysd
㠨	msqf
㠲	mhxn
㠴	mhvy
㠶	mhtm
㠷	mhey
㠸	mhfw
㠹	mhwj
㠺	mhit
㠼	mhrh
㠽	mhtu
㡁	mhdn
㡃	mhwq
㡄	mhqj
㡅	mhqq
㡆	mhyq
㡇	mhbn
㡈	mhqq
㡉	mhxx
㡊	mhqv
㡋	mhdn
㡌	mhje
㡎	mhce
㡏	mhwj
㡐	mhuj
㡒	mhrh
㡓	mhpl
㡕	mhad
㡖	mhtf
㡗	mhrm
㡘	mhuo
㡙	mhtx
㡚	mhff
㡛	mhaq
㡜	mhwi
㡝	mhtp
㡞	mhlv
㡟	mhgj
㡠	mhwu
㡡	mhdf
㡢	mhjn
㡤	mhow
㡥	mhen
㡦	mhpm
㡧	mhpu
㡨	mhwg
㡪	mhet
㢠	mkpd
㢥	mgka
㤟	manu
㥈	mhhn
㥖	mywn
㪜	mdmc
㰞	mqwy
㲘	mtfn
㶡	moi
㻃	magy
㼘	mgnn
㼙	mhgn
㼜	mdgn
㼷	mdmn
㽕	mnnb
㿮	mdhc
䍏	mjgd
䍑	mqqf
䍞	mqqg
䎃	mfng
䐌	mawe
䒋	mdqc
䝧	mqug
䝩	mwet
䝪	mnhy
䝫	mthf
䝬	mygg
䝭	mqkg
䝮	myxy
䝯	mtbn
䝰	mffy
䝲	mnyu
䝵	mgey
䝶	myiy
䝸	mafc
䝹	mpqb
䝻	mndg
䝼	mgeg
䝽	mdff
䞀	mwnd
䞁	majv
䞂	mdmd
䞃	mgct
䞅	mdfk
䞆	mimy
䞈	meto
䞉	mudm
䞊	mhah
䞋	musq
䞌	mtdg
䞍	mgeg
䞎	mjjg
䞏	mlny
䞐	mdwj
䢗	mapd
䢙	mpi
䢛	mwkp
䢳	mbh
䢷	mybh
䣙	meeb
䥚	mhhq
䨉	mmvy
䫈	mwym
䫚	mnmm
䫸	mtjv
䫹	mtja
䫻	mtjj
䫼	mtjw
䫽	mtjn
䫾	mtjt
䫿	mtjk
䬀	mtjl
䬁	mtjx
䬂	mtjt
䬃	mtju
䬄	mtjt
䬅	mtjl
䬆	mtjj
䬈	mtjq
䬉	mtjo
䬊	mtjw
䬋	mtjt
䬍	mtjn
䬎	mtjg
䬏	mtjk
䬐	mtjv
䬑	mtje
䬒	mtjc
䬓	mtjj
䬔	mtjj
䬕	mtjj
䬖	mtjg
䬘	mtjk
䬙	mtjm
䬚	mtjc
䬛	mtjf
䬜	mtjc
䬝	mtjw
䬞	mtjf
䬟	mtjj
䯆	menn
䯇	meln
䯈	mefq
䯉	meqw
䯊	mesk
䯋	medc
䯌	menv
䯍	mewc
䯎	mewf
䯏	metd
䯐	memw
䯑	meiq
䯒	meth
䯓	meff
䯔	mepa
䯕	metp
䯖	meye
䯗	mexf
䯘	mepq
䯙	megy
䯚	mexe
䯛	mepb
䯜	mejr
䯝	mede
䯞	memk
䯟	meue
䯠	mejl
䯡	meuo
䯣	mekm
䯤	mewj
䯥	mejo
䯦	meat
䳙	mgno
䳥	mwyo
䳪	mdmo
䳽	mwyo
䴍	mmwo
䵊	myaw
䶓	mhyj
䶲	mftx
㓾	nirj
㔉	ntkj
㕞	nmhc
㞋	nci
㞌	nbd
㞍	nvyi
㞎	ncv
㞏	ntpi
㞐	nud
㞑	nffn
㞒	nthd
㞓	nxjd
㞔	nqqi
㞕	nwed
㞖	ngmi
㞗	nfiy
㞘	neyi
㞙	ntfi
㞚	ntfv
㞛	ntxj
㞜	nttv
㞞	ntwh
㞟	nusd
㞠	ndui
㞡	naae
㞯	nmj
㟩	natm
㠯	nhnd
㠱	nadw
㢡	nhda
㣺	nhty
㣺	nyi
㣼	nvyy
㣾	ncyy
㣿	nqyy
㤃	nyn
㤄	ngmh
㤆	nrcy
㤇	ntdy
㤈	nny
㤉	naht
㤊	nqqy
㤋	nwvn
㤌	nafg
㤏	ntuy
㤑	ndkg
㤒	ndfh
㤓	nsgg
㤔	nwfy
㤕	nbmh
㤖	npsh
㤘	nqvg
㤚	ntfh
㤛	nwtf
㤜	ndyt
㤝	nycq
㤞	npta
㤡	ngqj
㤢	ndeg
㤤	njqy
㤥	nynw
㤦	ngkq
㤧	nrgk
㤨	nawy
㤬	nffg
㤭	ntdj
㤯	nmwk
㤱	ngku
㤳	ngik
㤴	nbnn
㤶	ndne
㤷	nwyk
㤸	nfoy
㤹	nfiy
㤺	nynq
㤼	nfcl
㤽	ndtf
㤾	npws
㤿	ndjn
㥀	nfhg
㥂	njgf
㥃	nug
㥄	nfwt
㥅	nepc
㥆	nviy
㥇	naat
㥉	nukg
㥊	neeg
㥌	nqoy
㥍	nadw
㥏	nmaw
㥒	nesy
㥓	ndsk
㥔	nyce
㥗	njyy
㥘	nfcy
㥙	nkhn
㥚	nvwy
㥛	nbkg
㥜	nleg
㥝	nxbg
㥞	nuey
㥟	nxey
㥠	nnhe
㥡	nnxs
㥢	nusg
㥥	njmy
㥧	ndmy
㥩	nftj
㥪	novg
㥫	nyjg
㥬	nupy
㥭	ndwi
㥮	nqbt
㥰	nvhc
㥱	nadd
㥳	ndri
㥴	nrhm
㥵	nley
㥸	naln
㥺	nfcl
㥼	ngho
㥽	ngmy
㥾	naak
㦀	ntdp
㦃	nutg
㦅	naqh
㦆	nhah
㦇	nynx
㦈	nugl
㦉	nfpu
㦊	nagf
㦋	ndfj
㦍	nkkt
㦎	nvfg
㦏	nnnw
㦐	nafm
㦑	nnbt
㦒	nlyg
㦓	nqdo
㦕	nbtg
㦖	nuny
㦗	nssi
㦙	njmn
㦜	nawc
㦠	nogf
㦡	nxrs
㦢	ntvb
㦥	npdn
㦦	nuvq
㦧	ntfj
㦨	nugi
㦩	nben
㦪	noyc
㦫	ntfm
㦬	nlxy
㦭	nfkw
㦻	nrat
㪬	nwyc
㰝	nqwy
㰺	nhfw
㱼	nmcy
㵨	nkui
㷉	nfof
㸛	nhdk
㸜	nhda
㿿	nhlf
䊢	nhdo
䍿	ngf
䎀	nant
䎂	nqnn
䎆	nwyc
䎈	njxt
䎉	ndyt
䎌	nkhy
䎍	ngey
䎎	nbnn
䎑	nviy
䎒	naat
䎓	nijg
䎔	ngef
䎚	ndhn
䛐	ngky
䢃	nkuq
䢧	nwep
䢰	nwyp
䣁	nbh
䣝	nftb
䪏	nhkw
䪐	nhkt
䪑	nhkx
䪒	nhkg
䪓	nhkk
䪔	nhky
䪕	nhko
䪖	nhkt
䪗	nhkc
䪘	nhkh
䪙	nhkf
䪚	nhkn
䪛	nhkl
䪜	nhky
䪝	nhkc
䪱	ndmy
䪸	nadm
䫗	nhfm
䬤	nwye
䲩	nwvo
䲿	nxwo
䴙	nkug
䵼	nhdn
㐘	onb
㔂	oqaj
㥕	oonu
㥹	owvn
㮡	oans
㱉	oguw
㲜	ootn
㲫	ogun
㲭	ooon
㶢	ovb
㶤	oqy
㶥	ofh
㶦	ocbh
㶧	omwy
㶩	opqn
㶬	ogsy
㶭	oxln
㶯	oqtb
㶰	oafg
㶱	osgg
㶲	oeh
㶴	oqqy
㶶	opey
㶷	oqjg
㶸	olll
㶹	oaiy
㶺	ogdk
㶼	octd
㶽	okmw
㶿	ofpb
㷀	oonf
㷁	oceh
㷃	odeu
㷄	ojsy
㷆	ownf
㷈	odjn
㷋	oooy
㷌	ovph
㷍	owga
㷎	ojqn
㷐	ovfg
㷑	osff
㷒	ojmy
㷓	oqrn
㷔	oehj
㷘	ocks
㷙	ouej
㷚	oyps
㷜	oyod
㷝	opwd
㷞	odjb
㷟	ownp
㷠	ooqh
㷣	ough
㷥	oobg
㷧	odri
㷨	omth
㷪	owye
㷬	oajd
㷮	ogmj
㷯	ofdh
㷰	oybc
㷲	otgl
㷵	olfo
㷷	onnw
㷸	ojgf
㷹	oahj
㷻	orlo
㷽	oudk
㷾	ohae
㷿	owgw
㸀	oymf
㸁	oogw
㸄	oyjg
㸅	otvb
㸆	otfd
㸇	ofwm
㸉	ouoo
㸊	ogkm
㸌	ofwy
㸍	ohaa
㸎	obbb
㽊	oyon
㽔	oetg
㽦	oopl
䁝	ooph
䃕	oopd
䉺	oag
䉻	oqan
䉼	orh
䉽	oufh
䉿	otuh
䊀	odg
䊁	otfq
䊂	ogmi
䊃	omgh
䊅	oqkg
䊇	ogey
䊈	otxu
䊉	opsy
䊊	ontn
䊋	onhf
䊌	oyxx
䊎	oudb
䊏	oooy
䊐	ojxx
䊑	oimk
䊒	owyg
䊓	ojgh
䊔	oamd
䊕	ovfp
䊖	ofmf
䊗	orgg
䊘	omeg
䊚	ownp
䊛	oqsc
䊜	ogjf
䊝	oton
䊞	oumd
䊟	oamy
䊡	ojlc
䊣	oamw
䊤	osjh
䊥	ovfj
䊦	ofpu
䊧	oxjm
䊩	otol
䊪	oajy
䊫	oldd
䊭	ofnf
䊮	onwy
䊯	oyaw
䊰	oyfj
䊱	owwg
䊳	oysd
䊴	otww
䎕	oopn
䙺	ohqn
䚏	oqaq
䝁	oopu
䝉	opeu
䢠	oapk
䢯	ooqp
䪯	oopj
䲴	owvo
䴆	oguo
䶴	oqwa
㓀	phu
㓁	pqb
㓁	pwu
㓂	pfqv
㓃	pyta
㔤	ptol
㝉	pgf
㝊	pcu
㝋	pbj
㝌	pqyu
㝍	pgng
㝎	ppu
㝏	pwjj
㝐	pwcu
㝑	pyb
㝒	pdf
㝓	pwgk
㝔	puqu
㝕	pncu
㝖	pqqu
㝗	pyve
㝘	pyf
㝙	pggw
㝚	pthp
㝛	pwgw
㝜	pajf
㝝	pssu
㝞	pgfg
㝟	pghq
㝠	pjuu
㝡	pbcu
㝢	ptky
㝣	pdhd
㝤	pfjf
㝥	pnho
㝦	pwye
㝧	pvwf
㝨	pfke
㝩	pyvi
㝪	pfuy
㝫	pbtg
㝬	pdhw
㝭	pnjg
㝮	pbmc
㝯	ptdk
㝰	pthy
㝱	pnhq
㝲	pnhh
㥶	pfjn
㪡	pdhc
㪦	pgmt
㮤	pwws
㱽	pqmc
㲁	pwac
㲅	pdhc
㲰	pnln
㲾	piu
㼠	pxgn
㼸	pwwn
㿾	pslf
䀂	pvlf
䀄	pntl
䀅	pyfl
䁇	pnth
䃼	pyhy
䃽	pyfc
䃾	pyxx
䃿	pyfw
䄀	pyat
䄁	pyan
䄂	pymg
䄃	pymd
䄄	pyld
䄆	pytd
䄇	pykg
䄈	pygu
䄉	pytt
䄊	pyfn
䄋	pydn
䄌	pycc
䄍	pyaj
䄎	pydk
䄏	pyad
䄑	pyqj
䄒	pywn
䄓	pyrg
䄔	pyty
䄕	pyil
䄖	pywj
䄗	pyjg
䄘	pyuy
䄙	pypu
䄚	pygj
䄛	pylv
䄜	pyyc
䄝	pydv
䄞	pywi
䄠	pyyg
䄡	pyqy
䄢	pyyj
䄣	pyfm
䄤	pygm
䄥	pyfw
䅁	pvtu
䆑	pwsj
䆒	pwvy
䆓	pwcq
䆔	pwkh
䆕	pwnw
䆖	pwdc
䆗	pwkh
䆘	pwlj
䆙	pwgh
䆚	pwmk
䆛	pwka
䆜	pwde
䆝	pwtl
䆞	pwjx
䆟	pwwk
䆠	pwah
䆡	pwye
䆢	pwrw
䆣	pwde
䆤	pwtt
䆥	pweu
䆦	pwoo
䆧	pwtv
䆨	pwjd
䆩	pwhd
䆫	pwqn
䆬	pwkm
䆭	pwlf
䆮	pwic
䆯	pwcv
䆰	pwak
䆱	pwio
䆲	pwyi
䆳	pwep
䆴	pwqn
䆵	pwuj
䆶	pwwo
䆷	pwck
䆸	pwwu
䆹	pwuf
䆺	pwtl
䆻	pwnt
䆼	pwmp
䆽	pwhe
䆾	pwal
䆿	pwns
䇀	pwab
䇁	pwqd
䎙	pgin
䒌	pjuc
䗕	pqbj
䗙	pfjj
䗝	pyjj
䘛	pumn
䘜	pumh
䘝	puay
䘞	pucg
䘟	puxh
䘠	pudq
䘢	pups
䘣	puhx
䘤	pusy
䘥	pulh
䘦	punx
䘧	pumd
䘨	puuq
䘩	puqj
䘪	puyq
䘬	puad
䘭	pugf
䘯	puie
䘰	putp
䘲	puvc
䘳	puqg
䘴	pusc
䘵	puvi
䘶	pubb
䘷	puui
䘸	puyy
䘹	puyf
䘺	puph
䘻	puye
䘼	pupb
䘽	puvq
䘾	pupn
䘿	punm
䙀	puee
䙁	puaa
䙂	puwn
䙃	pude
䙄	putv
䙅	pusv
䙆	puwd
䙇	pudd
䙈	puwd
䙉	purh
䙊	pugh
䙋	pupg
䙌	pukm
䙍	punh
䙎	pued
䙏	pugf
䙐	pugh
䙑	puye
䙒	puyl
䙓	pulc
䙔	puak
䙕	puth
䙖	pume
䙗	puud
䙘	pudt
䙙	punh
䙛	puue
䙜	putp
䙞	puwu
䙟	pulh
䙠	pudw
䙡	pukm
䙢	puuj
䙣	pugd
䙤	pump
䙥	pufc
䙦	puaq
䙧	puto
䙨	puje
䙩	puae
䙫	puuw
䙬	pumv
䙭	puph
䙮	puay
䙯	pudh
䙰	puyy
䙱	punj
䙾	pxhq
䚔	pgiq
䞿	pfjh
䢆	pmdf
䢇	pmdf
䢓	pgfp
䢘	pfpi
䢿	pvbh
䥌	pjjq
䧵	pqwy
䨈	pgiy
䪴	pqdm
䫅	psdm
䫤	pjum
䳦	pgjo
䴁	pjmo
䴐	pgro
䵫	pqbo
㐅	qty
㐥	qegn
㓩	qejh
㔨	quxe
㔩	qfcl
㔪	qhlo
㕁	qdcb
㗮	qkyw
㘶	qahf
㙰	qevf
㚇	qbwt
㚈	qfh
㚊	qqyw
㚋	qqmk
㚌	qqjs
㚍	qqkm
㚟	qkxd
㝁	qjbf
㠾	qbmh
㣻	qnu
㤮	qtgn
㤻	qytn
㩻	qdbc
㩼	qqfc
㪆	qayc
㫚	qrjf
㬟	qruj
㰬	qjqw
㱀	qbtw
㲋	qkxx
㲒	qktn
㲳	qayw
㷇	qqdo
㷺	qvto
㸋	qotl
㸚	qqqq
㹝	qtqa
㹞	qtrh
㹟	qtnw
㹠	qtgn
㹡	qtyx
㹢	qtlk
㹣	qttu
㹤	qtfc
㹥	qtyg
㹦	qtvk
㹧	qtmd
㹨	qtmg
㹩	qtcf
㹪	qtmg
㹫	qtgw
㹬	qtgq
㹭	qtjx
㹮	qtdj
㹯	qtws
㹰	qtiq
㹱	qtkh
㹲	qtfb
㹳	qtgk
㹴	qtgq
㹵	qtga
㹶	qttp
㹷	qdmd
㹸	qtrq
㹹	qtyw
㹺	qtij
㹻	qttv
㹼	qtqo
㹽	qtaa
㹾	qttk
㹿	qthj
㺀	qtqn
㺁	qtvq
㺂	qtdt
㺃	qtak
㺄	qtwj
㺅	qtqd
㺆	qtym
㺇	qtad
㺈	qtbj
㺊	qtun
㺋	qtwn
㺌	qtuo
㺍	qtpw
㺎	qtyh
㺏	qtlv
㺐	qtvs
㺑	qtce
㺒	qtne
㺓	qtgm
㺔	qteo
㺕	qttl
㺖	qtnt
㺗	qtkf
㺘	qtwo
㺙	qtpm
㺚	qtfp
㺛	qtca
㺜	qtme
㺝	qtal
㺞	qtww
㺟	qtny
㺠	qtpy
㺡	qtdh
㺢	qtfy
㺣	qtha
㺤	qtwg
㺥	qtqy
㺦	qtbg
㺧	qtkk
㼝	qbgn
㽜	qblf
䀏	qhd
䀜	qrhf
䀤	qhhf
䌛	qyti
䏑	qmww
䖊	qham
䖤	qbju
䚗	qewc
䚙	qegg
䚚	qetq
䚛	qetk
䚜	qerf
䚝	qeyf
䚞	qesw
䚟	qejf
䚠	qejx
䚡	qeln
䚢	qeas
䚣	qejh
䚤	qejy
䚥	qexu
䚦	qerm
䚧	qene
䚨	qewc
䚩	qetk
䚪	qele
䚬	qeoh
䚭	qeay
䚻	qyf
䝆	qreu
䢑	qayp
䢣	qypd
䣀	qdbb
䤛	qnhh
䤜	qtan
䤝	qqbh
䤞	qdnn
䤟	qpmn
䤠	qhg
䤡	qmfg
䤢	qkln
䤣	qtuh
䤤	qynw
䤥	qqdb
䤦	qwat
䤧	qlkg
䤨	qrey
䤩	qpta
䤪	qmsy
䤫	qmwn
䤬	qiit
䤭	qqdh
䤮	qhit
䤯	qgae
䤱	qmrh
䤲	qfoy
䤳	qywy
䤴	qbib
䤵	qdjd
䤶	qdjn
䤷	qajv
䤸	qxey
䤹	qpoc
䤺	qdrh
䤻	qdae
䤼	qriy
䤽	qliy
䤾	qevg
䤿	qdhr
䥀	qbhj
䥁	qclf
䥂	qpfe
䥃	qpwy
䥄	qdaj
䥇	qynn
䥈	qada
䥉	qpqy
䥊	qgmy
䥋	qybo
䥎	qdfe
䥏	qtrb
䥑	qswt
䥓	qadf
䥔	qsoy
䥕	qumt
䥖	qusd
䥗	qffw
䥘	qwwj
䥙	qbue
䥛	qdhi
䥜	qusy
䥝	qynx
䥞	qryt
䥟	qrjn
䥠	qadt
䥡	qths
䥤	qfqn
䥥	quto
䥦	qdap
䥧	qhph
䥨	qukk
䥩	qtmt
䥪	qjxo
䥫	qfay
䥬	qagf
䥮	qsab
䥯	qlcx
䥰	qynj
䥱	qpvo
䥲	qakw
䥳	qdet
䥴	qmwm
䥵	qjfq
䥶	qdth
䥷	qthj
䥹	qdhb
䥺	qaht
䥻	qfqn
䥼	qqrt
䥽	qnty
䥾	qpgg
䥿	qrdn
䦀	qng
䦁	qdtb
䦂	qynn
䦃	qafj
䦄	qgje
䦅	qudk
䦆	qhhc
䪷	qkdm
䫂	qqdm
䫒	qajm
䭪	qnjf
䰲	qonn
䰳	qosh
䰴	qotn
䰵	qobg
䰶	qoyn
䰷	qodh
䰸	qowc
䰹	qoat
䰺	qorh
䰻	qoty
䰼	qown
䰽	qogh
䰾	qocn
䰿	qotb
䱀	qomd
䱁	qosg
䱂	qoxl
䱃	qorw
䱄	qory
䱅	qogs
䱆	qoeb
䱇	qojg
䱈	qofi
䱉	qoeg
䱊	qooy
䱋	qoaw
䱌	qoah
䱍	qogg
䱎	qogg
䱏	qogu
䱐	qoeb
䱑	qorr
䱒	qokc
䱓	qotp
䱔	qowt
䱕	qotu
䱖	qogn
䱙	qohc
䱚	qovi
䱛	qoag
䱜	qoaj
䱝	qorf
䱞	qodi
䱟	qond
䱠	qoaa
䱡	qoqo
䱢	qoqh
䱣	qoyf
䱤	qoqv
䱦	qowy
䱧	qoub
䱨	qogj
䱩	qomn
䱪	qoge
䱬	qone
䱭	qong
䱮	qodd
䱰	qotf
䱱	qouh
䱲	qoxe
䱳	qodf
䱴	qong
䱵	qown
䱶	qoyb
䱸	qovc
䱹	qoua
䱺	qomu
䱻	qome
䱼	qone
䱽	qowk
䱾	qolv
䱿	qolr
䲁	qonf
䲂	qoyh
䲃	qovs
䲄	qott
䲅	qofq
䲆	qoqo
䲇	qogp
䲈	qoys
䲉	qoar
䲊	qobe
䲋	qofj
䲌	qofw
䲎	qont
䲏	qool
䲐	qohl
䲑	qout
䲒	qoqh
䲓	qoww
䲔	qogg
䲕	qouj
䲖	qoff
䲗	qoth
䲘	qotn
䲙	qotb
䲚	qogm
䲛	qoah
䲜	qoqo
䲝	qgwb
䲞	qgug
䲟	qgqb
䲠	qgdj
䲡	qgug
䲤	qgig
䲭	qgdj
䳿	qdoo
䴂	qjeo
䵶	qkxg
㐆	rvnv
㐝	rqkn
㒵	rwu
㓡	rmjh
㔕	rnln
㔼	rwyf
㚖	rdu
㡍	rdmh
㣎	rier
㣐	riet
㦘	rytn
㦵	riat
㧃	rnhh
㧄	rbh
㧅	rvn
㧆	rmhh
㧇	rmgg
㧈	rxn
㧉	rrnn
㧊	rgmh
㧋	rdy
㧌	rtfn
㧍	ryn
㧎	raht
㧏	rmqy
㧐	rccy
㧑	ryly
㧒	rpwy
㧓	rrcy
㧔	rdnt
㧕	rqtb
㧖	rynn
㧗	rhxn
㧙	rntt
㧚	rgnn
㧜	ramh
㧞	rtdc
㧟	rian
㧠	rciy
㧡	rynw
㧢	rldy
㧣	rriy
㧤	rycq
㧥	rtfq
㧦	rqjg
㧧	rycq
㧨	rrgk
㧩	rmgh
㧪	rqdb
㧫	rdmj
㧮	rvg
㧯	rftx
㧰	rqiy
㧲	rpsy
㧳	rwvr
㧴	rtrt
㧵	rgik
㧶	rtmt
㧷	rgdk
㧸	rybh
㧹	rjgf
㧺	rijg
㧻	reyy
㧼	rgey
㧽	rldg
㧾	rqrn
㧿	rwwh
㨀	rtgi
㨁	rfhg
㨂	rgji
㨃	rybg
㨄	rmfk
㨅	ramw
㨆	rssy
㨈	ryjg
㨉	rnaj
㨊	rdae
㨋	rftj
㨎	rdmd
㨏	rmdo
㨐	rwks
㨑	rqbt
㨒	rdff
㨓	rpwh
㨔	rdgt
㨕	recl
㨖	rgct
㨗	rhvh
㨘	rith
㨙	rexd
㨚	raqj
㨛	ruwy
㨜	rhay
㨝	rnie
㨞	rgxi
㨟	rmgu
㨠	rpju
㨡	rley
㨢	rcex
㨣	rwcn
㨤	rawy
㨥	rxmw
㨦	rwyc
㨧	rcdl
㨨	rqyl
㨩	rytp
㨪	rjiq
㨫	rjtl
㨬	rfke
㨭	rync
㨮	rqrq
㨯	rybb
㨰	ruce
㨱	rqyg
㨲	raps
㨳	rpdk
㨴	rfjn
㨵	ruev
㨶	rwvo
㨷	rakg
㨸	rpnm
㨹	rdhv
㨺	ramy
㨽	rgkj
㨾	rugi
㨿	rham
㩀	rhay
㩁	rpwy
㩂	rqef
㩃	rpfu
㩄	rmln
㩅	rgal
㩆	ryin
㩇	rvfg
㩈	rpwk
㩉	rwgn
㩊	relf
㩋	rvfj
㩌	rxjm
㩍	rtgi
㩎	rjed
㩏	rlfo
㩐	rtff
㩑	rgdd
㩒	rssi
㩔	rnac
㩕	rfwc
㩖	rglg
㩗	rmwe
㩘	rugt
㩙	rpff
㩚	rape
㩛	rlgf
㩜	rahl
㩝	rype
㩞	roos
㩟	rpfs
㩠	ryno
㩡	rddd
㩢	ralt
㩣	rnpl
㩤	rget
㩥	rfag
㩦	rwyk
㩧	rjai
㩨	rdhn
㩩	rxim
㩪	rxdm
㩫	rrrm
㩬	rhaa
㩭	rwfb
㩮	rwfr
㩯	rtxi
㩰	raks
㩱	relf
㩲	raky
㩳	rwyc
㩴	rhhy
㩵	rhad
㩶	rtgq
㩷	rpfc
㩸	rllg
㩹	rllg
㪂	rnhc
㪏	rtfc
㰟	rnqw
㰾	ryqw
㲴	rnkh
㲵	rnie
㲶	rnho
㲷	rnkf
㸕	rhyc
㼉	rcyq
㼌	rcyy
㼎	rcyq
㼒	rcyr
㼓	rcyo
㼖	rcyj
㼟	rgnn
㼡	rign
㼰	rtfn
㿝	rcu
㿞	rtfn
㿟	rrg
㿠	riqn
㿡	riqb
㿣	rjqn
㿤	rdwj
㿥	rpwy
㿧	rfnf
㿨	rdth
㿩	ripo
㿭	ryhc
㿱	rrhc
䀸	rrhf
䋢	rrxi
䍂	rmgf
䍄	rmhk
䍅	rmwc
䍆	rmps
䍇	rmtp
䍈	rmgh
䍉	rmkw
䍊	rmuq
䍋	rmtf
䍌	rmuk
䍎	rmao
䎅	rng
䖐	rham
䚌	rdfq
䚫	ryte
䟟	rykh
䣃	rhbh
䣗	rdfb
䫌	rtfm
䫢	rham
䫥	rqcm
䫧	rdfm
䭁	rrwe
䰠	rqch
䰡	rqcw
䰢	rqch
䰣	rqcq
䰦	rqcf
䰧	rqcm
䰨	rqch
䰫	rqcq
䰬	rqck
䰮	rqct
䰯	rqch
䱥	rmho
䳆	rwvo
䳨	rgwo
䳲	rdfo
䴘	rhag
㐉	snb
㐓	sknb
㓼	swij
㔄	sojh
㙬	swwf
㟚	sfcm
㢦	sksa
㪃	skhc
㪔	sshc
㪼	skrh
㭁	sen
㭂	siy
㭃	sxy
㭄	snfh
㭅	sdg
㭇	scqn
㭈	snwy
㭊	sthn
㭋	sdhh
㭌	srhh
㭎	smqy
㭏	sfnh
㭑	sfiy
㭒	snhn
㭓	scah
㭔	stuh
㭕	sfcy
㭖	sway
㭗	slf
㭘	swgk
㭙	sffy
㭚	stey
㭛	srey
㭜	sadt
㭝	ssvb
㭞	sitl
㭠	stfq
㭡	stlq
㭢	sgaj
㭣	sukg
㭤	sqyg
㭥	sqmy
㭦	spta
㭨	sahb
㭩	sefy
㭪	sgey
㭫	swwf
㭬	sey
㭭	sklj
㭮	svgq
㭯	sbnn
㭱	salh
㭲	swwk
㭳	sftb
㭴	sjcf
㭵	sqlg
㭶	sayn
㭷	slln
㭸	sqky
㭹	sxyx
㭺	sdjn
㭻	simk
㭼	sijg
㭽	syqy
㭾	snbm
㭿	sjqb
㮀	sbib
㮁	sqde
㮃	stvg
㮄	sfqy
㮅	swyf
㮆	swud
㮇	sgdn
㮈	sdfi
㮉	swgw
㮊	scbs
㮋	sdeb
㮌	sdmd
㮎	sgil
㮏	ssfi
㮐	sith
㮑	stfv
㮒	ssfg
㮓	sngg
㮔	stgf
㮕	sdmd
㮖	safh
㮘	scbt
㮙	skkn
㮛	sjgh
㮜	sanf
㮝	swwb
㮞	suqk
㮟	sdsy
㮠	saps
㮢	swnd
㮥	scdl
㮦	sfpi
㮧	swno
㮨	slwt
㮩	sthn
㮪	sams
㮫	spdk
㮬	swcn
㮭	sclf
㮮	sdhr
㮯	sley
㮰	stlx
㮱	satq
㮲	sqbt
㮳	seud
㮴	svhc
㮵	syty
㮶	sube
㮷	sdnj
㮸	sudp
㮹	sgct
㮺	sgkk
㮻	scyj
㮼	synn
㮽	stec
㮿	sjaf
㯀	syth
㯁	sbuk
㯂	saqh
㯃	sswi
㯄	ssrc
㯅	syrf
㯆	sutg
㯇	sdjf
㯈	sgkp
㯉	shah
㯊	sgho
㯌	sepy
㯍	snhf
㯎	sysy
㯑	sxde
㯒	sehq
㯓	swgn
㯕	sadr
㯖	sfln
㯗	susy
㯘	sffw
㯙	syct
㯚	stwk
㯛	sfpg
㯜	sayf
㯝	skhk
㯞	sxke
㯟	ssvi
㯠	syxh
㯡	swin
㯢	snnw
㯣	saws
㯤	swww
㯦	sads
㯧	sfhk
㯨	ssoy
㯪	sfwc
㯫	shae
㯬	ssvp
㯭	shal
㯮	slqj
㯯	stam
㯰	slfh
㯲	sssi
㯳	saqt
㯴	sapk
㯵	satf
㯶	sqot
㯷	swoy
㯸	svhl
㯹	ssff
㯼	safl
㯽	spnm
㯾	sgmp
㯿	svln
㰀	stqi
㰁	sddd
㰂	sptl
㰃	srmi
㰄	smaa
㰅	sump
㰇	sfag
㰈	sslp
㰉	sgct
㰊	sfwo
㰋	shim
㰌	sfwy
㰎	smwm
㰏	styk
㰐	sbdp
㰑	snns
㰒	swfb
㰓	sahm
㰔	soyc
㰕	sugt
㰖	sahq
㰗	sdhh
㰘	sxga
㰙	saky
㰚	syby
㰛	saxs
㰜	sfhm
㰤	skqw
㱈	ssfw
㲡	sfin
㶾	sgou
㷊	ssou
㼗	sgnn
㼼	sfin
䅇	stu
䊲	soug
䙪	sqqe
䙲	sdu
䙳	sou
䙴	sdnb
䙵	sfff
䙶	spey
䚅	swwq
䚈	sfhq
䚓	sjhq
䠂	sskh
䢞	sspi
䢶	sbh
䣛	swib
䣥	sgxn
䣦	sgln
䣧	sgay
䣨	sgta
䣩	sggn
䣪	sggh
䣫	sgfc
䣬	sgat
䣭	sgdy
䣮	sgdc
䣯	sgeg
䣰	sgan
䣱	sgqk
䣲	sgca
䣳	sgnk
䣴	sgqq
䣵	sgbg
䣶	sgtd
䣷	sgri
䣹	sgwa
䣺	sgke
䣻	sgwk
䣼	sgyi
䣾	sgpg
䣿	sggl
䤀	sgak
䤁	sgan
䤂	sgas
䤃	sguj
䤄	sgdd
䤅	sgwj
䤆	sgwd
䤇	sgpc
䤈	sgwl
䤉	sgnl
䤊	sgab
䤌	sgwk
䤍	sgay
䤎	sgck
䤏	sgdr
䤐	sgaj
䤑	sgaw
䤒	sgxt
䤓	sgae
䤕	sgxs
䤖	sgji
䤘	sgwg
䤙	sgxj
䫐	ssdm
䫴	ssfm
䫶	sqqm
䳩	svwo
䳵	swwo
䴬	swwa
䴭	swwt
䴮	swwm
䴯	swwr
䴰	swwa
䴱	swwx
䴲	swws
䴳	swww
䴴	swwk
䴵	swwa
䴶	swwh
䴷	swwq
䴸	swwb
䴹	swws
䴺	swwk
䴼	swwa
䴽	swwf
䴾	swwa
䴿	swwe
䵀	swwm
䵁	swwf
䵂	swwd
䵃	swww
䵄	swwu
䵆	swwe
㐈	tynb
㐌	tbb
㐑	tunb
㒰	tyaf
㒱	tyqu
㒲	tyjf
㒴	tybm
㓢	tkjh
㓷	thsj
㓿	twij
㔍	thaj
㔐	tgdj
㔓	tfln
㔚	tdln
㔞	tful
㔟	tgvl
㔡	tlql
㕿	tkf
㘒	ttgx
㙑	tkmf
㚅	tgtg
㛷	tdnv
㟀	tmj
㠞	tmgm
㠳	tymh
㡑	tomh
㣊	ter
㣔	tsh
㣕	tdy
㣖	tdyy
㣗	tynt
㣘	tqkg
㣙	tmg
㣚	tmgk
㣛	twgk
㣜	tgaj
㣝	tadt
㣞	twcq
㣟	tfkg
㣠	thtu
㣡	twkh
㣢	tuxt
㣣	tdww
㣤	taat
㣥	twff
㣦	ttvg
㣧	txen
㣨	tvdg
㣩	tssy
㣪	tefc
㣫	ttgf
㣬	tkbg
㣭	tqbt
㣮	tfmf
㣯	tnie
㣰	tton
㣱	tgmy
㣲	tmgt
㣳	trlo
㣴	tamw
㣵	tfup
㣶	tylg
㣷	tpns
㣸	toeg
㣹	tywn
㤀	tynn
㤩	tknu
㥎	tqtn
㦌	tfnn
㦣	tnhn
㩾	tgac
㩿	tnty
㪇	tfqt
㪓	tfuc
㪾	tkrh
㬱	tfqj
㭧	tesu
㯔	tfns
㰫	tfqw
㰱	tgjw
㰶	thkw
㲌	tfne
㲎	tfnn
㲏	thgn
㲐	tfnn
㲑	tfni
㲓	tfnt
㲙	tfnq
㲛	tdkn
㲝	tfny
㲧	tfnj
㲩	tfnn
㲮	tfnk
㲱	tfnn
㴝	tjwi
㶗	txgi
㶻	tdho
㷏	ttfo
㷗	tnho
㷩	taho
㷭	tdho
㸔	tuth
㸝	thgw
㸞	thgn
㸟	thgj
㸠	thgq
㸡	thgi
㸢	thge
㸣	thgw
㸥	thgy
㸨	trnh
㸩	trfh
㸪	trkh
㸫	trrh
㸬	trgh
㸭	trcn
㸮	trwv
㸯	truf
㸰	trpx
㸱	trtb
㸲	trtf
㸳	trwc
㸵	trfk
㸶	trld
㸸	trrk
㸹	tref
㸻	trcd
㸼	trth
㸽	trmy
㸾	trvn
㸿	trfm
㹀	trfb
㹁	tryi
㹄	trlt
㹅	trqn
㹆	trpl
㹇	trjn
㹉	trdi
㹊	trpy
㹋	trwe
㹌	trug
㹍	trud
㹎	trli
㹏	trag
㹐	twwh
㹑	tram
㹒	troy
㹓	trfq
㹔	trgg
㹖	true
㹗	trff
㹘	trfj
㹙	troh
㹚	trok
㹛	trgt
㼻	twwn
㽃	toln
㽓	tgtg
䀉	tdkl
䂏	tdvk
䂐	tdbm
䂑	tdhx
䂒	tdfk
䂓	tdhq
䂔	tdff
䂕	tdxe
䄟	tfni
䄦	tbh
䄧	ten
䄨	tgfh
䄩	tay
䄪	tqyy
䄫	tnn
䄬	tbn
䄭	ttfh
䄮	tfwy
䄯	tgah
䄰	taht
䄱	tyn
䄲	tmwy
䄳	thg
䄴	teg
䄵	tghf
䄶	txjh
䄷	tdg
䄸	trg
䄹	twtf
䄺	tgxw
䄻	tiqn
䄼	tgkw
䄽	tsg
䄾	tadt
䄿	tjxt
䅀	tgqj
䅂	ttkg
䅄	tlll
䅅	tffg
䅆	tuqw
䅉	tgog
䅊	tyta
䅋	tqkq
䅌	tkeg
䅍	ttfp
䅎	tten
䅏	tntn
䅐	thqn
䅑	tevg
䅒	tayn
䅓	tqkc
䅔	tvlg
䅕	tndg
䅖	tdjn
䅗	ttvg
䅘	tsww
䅙	tjxx
䅚	tudb
䅛	tjjg
䅜	ttgf
䅝	tpwa
䅞	tjgf
䅟	tcde
䅠	tjgh
䅡	tdmy
䅢	tmeg
䅣	trgg
䅤	ttfv
䅥	tjqn
䅦	talg
䅧	tujg
䅨	ttjg
䅩	tfcw
䅪	tkhm
䅫	tyji
䅬	tuwl
䅭	tupy
䅮	twyk
䅯	tyvk
䅰	tldn
䅱	tmgu
䅲	tftj
䅳	tqbt
䅴	tfpi
䅵	tugo
䅶	tdff
䅷	tawt
䅸	tauh
䅹	tlvg
䅺	tsfi
䅻	tybc
䅼	tjlc
䅾	taqj
䅿	tagf
䆀	tlfo
䆁	tlff
䆂	tyuo
䆄	tylg
䆅	tuqm
䆆	tkks
䆇	tmwo
䆈	tnip
䆉	tlcx
䆊	tuxw
䆋	tqxg
䆌	ttdy
䆍	tued
䆎	twwg
䆏	tolw
䇖	tqtr
䇗	twcu
䇘	tgxg
䇙	txhj
䇚	twhu
䇛	thf
䇜	tqwu
䇝	tar
䇞	taff
䇟	tqlb
䇠	tygf
䇡	tpsj
䇢	tdf
䇣	twiu
䇤	tgmw
䇥	tghf
䇦	tmdu
䇧	tgkw
䇨	ttah
䇩	tjxr
䇪	tgcf
䇫	tahh
䇬	triu
䇭	tftx
䇮	twtf
䇯	tbf
䇰	tbig
䇱	tltu
䇲	tguw
䇳	tdxy
䇴	tsf
䇵	tirj
䇶	tqej
䇷	tklj
䇸	tkgf
䇹	tvtk
䇺	tgku
䇻	tntn
䇼	tkcb
䇽	trrj
䇾	tyf
䇿	tgki
䈀	tmmj
䈁	twga
䈂	tuaj
䈃	tivk
䈄	tbib
䈅	takg
䈆	tynd
䈇	thjj
䈈	tecb
䈉	tuvf
䈊	tfwt
䈋	tijf
䈌	tieg
䈍	tynh
䈎	tans
䈏	tgkl
䈐	tndo
䈑	tmnk
䈒	tfmf
䈓	tjqn
䈔	tnhc
䈕	tjgh
䈖	ttuf
䈗	twct
䈘	tuxx
䈙	txfu
䈚	tckn
䈛	thmc
䈜	twvc
䈝	tnhe
䈞	tyjf
䈟	tmjj
䈠	tefc
䈡	tqrn
䈢	tcks
䈣	tght
䈤	tsaf
䈥	tqel
䈦	tqbt
䈧	teto
䈨	tbve
䈩	twgj
䈪	tgkh
䈫	txmw
䈬	tigy
䈭	trqc
䈮	tuqk
䈯	tfhw
䈰	trie
䈱	tevf
䈲	ttec
䈳	tjnf
䈴	tuvo
䈵	twcn
䈶	tpwk
䈷	tstk
䈸	tqef
䈹	tpwj
䈺	txtu
䈻	tegy
䈼	tpnm
䈽	takg
䈾	tsie
䈿	tpju
䉀	tyao
䉁	tbwc
䉂	tlxi
䉃	tnhf
䉄	tbft
䉅	tfuy
䉆	twvo
䉇	tadj
䉈	taet
䉉	tqey
䉊	tcdl
䉋	tvnh
䉌	tbue
䉍	tunu
䉎	tips
䉏	tqeh
䉐	tldf
䉑	trlo
䉒	ttol
䉓	tsjs
䉔	tgqa
䉕	tulj
䉖	tlwc
䉗	trkb
䉘	tspi
䉙	tffc
䉚	tlpn
䉛	ttmd
䉜	ttdy
䉝	tugt
䉞	tdgn
䉟	trwc
䉠	ttmt
䉡	tylg
䉢	tfwk
䉣	tvqo
䉤	tovt
䉥	trtn
䉦	tsdp
䉧	tqyj
䉨	tuec
䉩	tsak
䉪	tlll
䉫	ttqi
䉬	tywc
䉭	tvln
䉮	tuwy
䉯	tahm
䉰	tmeq
䉱	tpuk
䉲	txgq
䉳	tqod
䉴	tyke
䉵	thde
䉶	twyc
䉷	tkkt
䉸	tuyu
䉹	tfkw
䊍	tqto
䊬	tjso
䋣	txgi
䌓	txgi
䍧	trud
䎇	teng
䎊	tkng
䎋	tfkn
䎗	tdkn
䎹	tobf
䑙	tdmf
䑚	tdeg
䑛	tdqy
䑜	tdas
䑠	tebh
䑡	tecy
䑢	tegq
䑣	teet
䑤	tewn
䑥	teey
䑦	teqk
䑧	tewf
䑨	tetb
䑩	tedg
䑪	tewk
䑫	teua
䑬	teiq
䑭	teia
䑮	tems
䑯	teut
䑰	tehi
䑱	tepb
䑲	tehj
䑳	tewa
䑴	teaw
䑵	teje
䑶	tege
䑷	teye
䑸	tepi
䑹	tepc
䑺	temj
䑻	teyb
䑼	teqt
䑽	tejn
䑾	tewc
䑿	tepj
䒀	tetf
䒁	tenr
䒂	tenf
䒃	tetp
䒄	tepl
䒅	teuh
䒆	teyt
䒇	tepl
䒈	tefm
䒉	terh
䓥	tyaj
䖝	tji
䖸	trnj
䖽	tjju
䖿	tqtj
䗬	tdhj
䗺	thpj
䘏	tlbh
䘐	tlvw
䘑	tlyi
䘒	tlct
䘓	tlqv
䘔	tlpk
䘕	tymh
䘖	trmh
䘗	tmgh
䘘	tgxh
䘙	tnhh
䙻	tnhq
䚀	tehq
䚁	tmkq
䚐	tdkq
䚘	tqeh
䝷	tdkm
䠲	tmdc
䠳	tmdm
䠴	tmdu
䠵	tmdf
䠶	tmdd
䠷	tmdq
䠸	tmdn
䠹	tmdw
䠺	tmdk
䠻	tmdx
䠼	tmdj
䠽	tmdu
䠾	tmdw
䠿	tmdm
䡀	tmdg
䡁	tmdd
䡓	tlfh
䢤	tsyp
䢨	twwp
䢪	tdkp
䢴	tdbh
䢾	tfqb
䣋	tobh
䣽	tdkg
䧷	tuwy
䧼	tfky
䧽	towy
䨀	tyoy
䨂	towy
䪠	tnhg
䪡	tnhg
䪢	tnhg
䪿	tlqm
䫁	thdm
䫋	tvdm
䫝	tjdm
䫵	thpm
䭯	tjbm
䭰	tjdh
䭱	tjui
䭲	tjdk
䭳	tvrj
䱘	tjqo
䲍	teuo
䲼	tgwo
䳉	tuwo
䳠	tgao
䳯	tgjo
䳷	twwo
䴈	tmoo
䴻	tqtt
䵈	txts
䵑	twiy
䵒	twij
䵓	twih
䵔	twii
䵕	twid
䵗	twil
䵘	twir
䵙	twiq
䵚	twiv
䵛	twif
䵜	twie
䵩	tjlo
䵵	thdo
䵸	toxf
䵹	tdkx
䶊	thlf
䶋	thly
䶌	thln
䶎	thlk
䶐	thlj
䶑	thlh
䶰	txtn
䶱	tutx
㐮	ufje
㒸	ueu
㓅	ush
㓆	uwxn
㓇	utdy
㓈	udg
㓉	utdg
㓊	umgk
㓋	uawy
㓌	uwgg
㓍	uycq
㓎	uvpc
㓏	umwk
㓐	ufwf
㓑	ufuf
㓒	uawn
㓓	ufmf
㓔	utmf
㓕	udgt
㓖	ujaf
㓗	udhi
㓬	udvj
㔙	ualn
㔦	udyl
㕗	ugqc
㕠	uwyc
㖍	ufkx
㖖	ukf
㘏	uthx
㘳	uxff
㛳	upmv
㜪	usrv
㝺	uvot
㠮	uoga
㡀	umii
㡣	upmd
㣒	ulje
㤣	uanu
㦚	unuh
㪗	ukhc
㪠	uvoc
㪨	uduc
㪲	ufnb
㪳	ufkf
㪵	uduf
㭍	uasu
㮍	uejs
㰍	uegs
㰴	ukqw
㲔	utfn
㵗	uciu
㵷	uiuh
㷕	usgo
㷢	udao
㸂	uepo
㸤	uthu
㼱	uxpn
㼿	ujfn
㽀	usgn
㽱	unhk
㽲	ugnv
㽳	ugfk
㽴	udyi
㽵	ufd
㽶	unv
㽷	uii
㽸	upqv
㽹	urci
㽺	ueyi
㽻	ufci
㽼	uxhk
㽽	udd
㽾	ubmk
㽿	urcy
㾀	ufci
㾁	usyi
㾂	uckd
㾃	upxv
㾄	umd
㾅	utnt
㾆	umfd
㾇	uhd
㾈	uwfi
㾉	uwyc
㾊	ugmi
㾋	uwsi
㾌	utfq
㾍	udmj
㾎	ummg
㾏	uffd
㾐	ugqj
㾑	uwgk
㾒	uvkd
㾓	uked
㾔	ukkd
㾕	uuk
㾖	ujfd
㾗	uyve
㾘	ugjq
㾙	uqdh
㾚	uhxf
㾛	uvpc
㾜	udww
㾝	ulk
㾞	usgd
㾟	uhie
㾠	uqtg
㾡	ufcb
㾢	usww
㾣	uqd
㾤	upwa
㾥	uhic
㾦	uukd
㾧	ujsi
㾨	udsk
㾩	utfx
㾪	uith
㾫	uyna
㾬	uxxr
㾭	utoi
㾮	urgd
㾯	ulge
㾰	uded
㾱	uwfq
㾲	ugqt
㾳	uuqv
㾴	useg
㾵	uyfk
㾶	umed
㾷	urhm
㾸	uymk
㾹	uhxs
㾺	uci
㾻	ubwt
㾼	uvep
㾽	uwnp
㾾	uuvo
㾿	uyvb
㿀	ugyg
㿁	urdf
㿂	umgt
㿃	uaqh
㿄	uatc
㿅	uthh
㿆	utye
㿇	unrd
㿈	uxty
㿉	ukhm
㿊	uaqj
㿋	ukks
㿌	uwgw
㿍	uqeh
㿎	ufam
㿏	uvtd
㿐	ufhq
㿑	unwy
㿒	ufnf
㿓	udwh
㿔	ulll
㿕	uuqv
㿖	uhal
㿗	utmm
㿘	uook
㿙	ulld
㿚	ulxy
㿛	ugmx
㿜	utha
㿰	uqhc
㿶	upyc
㿷	udac
䀍	ujtl
䄅	udfi
䅈	udtu
䆃	utht
䇂	uhk
䇃	unn
䇄	utnn
䇅	uat
䇆	uufh
䇇	unan
䇈	ucfg
䇉	udg
䇊	uycy
䇋	uqqy
䇌	uieg
䇍	ukhy
䇎	uajg
䇏	uybg
䇐	uviy
䇑	urtf
䇕	ufdj
䉾	uxou
䌘	umii
䍨	udgh
䍩	udty
䍪	udgs
䍫	udpx
䍬	udgh
䍭	udxu
䍮	udiq
䍯	udqb
䍰	udld
䍱	udwt
䍲	udvq
䍳	udcc
䍴	udtv
䍵	udqh
䍶	udgi
䍷	udnh
䍸	udgf
䍹	udtd
䍺	udkn
䍻	udnw
䍼	udaj
䍽	uddh
䎖	uljn
䒍	upyc
䒏	uljc
䒑	uytg
䖭	udju
䘱	uwke
䚊	uwlq
䚒	ujfq
䡨	udal
䢏	ufpk
䢒	uqpi
䢭	ugup
䣡	ugtb
䤋	usgg
䤗	ujtg
䦌	ufd
䦍	utnv
䦎	ufqv
䦏	uwjk
䦐	urk
䦑	unwi
䦒	udd
䦓	uhkd
䦔	ujgd
䦕	uuak
䦖	ufkd
䦗	utld
䦘	uvei
䦙	uffi
䦚	utdd
䦛	uqvh
䦜	ugkd
䦝	ufoi
䦞	uigd
䦟	uwwf
䦠	ueyi
䦡	upnn
䦢	uifc
䦣	uukd
䦤	uccc
䦥	ussi
䦦	uqd
䦧	uvqv
䦨	ugji
䦩	uhti
䦪	ujqn
䦫	uamd
䦬	udhd
䦭	utjd
䦮	udwj
䦯	ugct
䦰	uqjn
䦱	ueto
䦲	uqdy
䦳	uxtb
䦴	ulff
䦵	ugwq
䦶	uqvh
䦷	uwwf
䦸	ujmy
䨆	umiy
䪦	ujag
䪧	ujbn
䪨	ujqy
䪩	ujwn
䪫	ujga
䪬	ujfb
䪭	ujuj
䪮	ujqt
䪰	ujun
䫄	ukqm
䫓	ukdm
䫕	upmm
䫞	ugom
䫡	uvom
䬇	ukqj
䭭	uthm
䳐	uqwo
䳝	ukwo
䳤	umio
䴀	ujfo
䴊	ugto
䴔	uqqg
䶏	uxhj
㐇	vnb
㐐	vcnb
㐒	vknb
㐡	vdmd
㐤	vfhw
㓯	vljh
㔅	vfjj
㖲	vkkx
㗠	vckx
㚑	vdu
㚣	vvf
㚤	vay
㚥	vgfh
㚦	vgjh
㚧	vyt
㚨	vnfh
㚩	vmfg
㚪	vtfn
㚫	veyy
㚬	vqug
㚭	vdnn
㚮	vpmn
㚯	vmqy
㚰	vgig
㚱	vrgg
㚲	vhkg
㚳	vlkg
㚴	vdmh
㚵	vtuy
㚶	vnhn
㚷	vwiy
㚸	vngk
㚹	vqtb
㚺	vebg
㚼	vlg
㚾	vkqn
㚿	vqnn
㛀	vqvg
㛁	vguh
㛂	vrcn
㛄	vyey
㛅	vbg
㛆	vesy
㛇	vyfg
㛈	vftn
㛉	vsg
㛊	vmsy
㛋	vwny
㛌	vcrh
㛍	vdww
㛎	vkkg
㛏	vfiy
㛐	vgjq
㛒	vgku
㛓	vqdh
㛔	vtdh
㛕	vkcn
㛖	vcwt
㛗	vwwf
㛘	vfpb
㛙	vuh
㛚	vceh
㛛	vtmt
㛝	vmy
㛞	vgah
㛟	vqmd
㛠	vujg
㛡	vpfq
㛢	vten
㛣	vkmy
㛤	vgmy
㛥	vijg
㛦	vssy
㛧	vmdg
㛨	vudn
㛩	vyce
㛪	vdjn
㛫	vjqr
㛬	vfwf
㛭	vajg
㛮	vpoc
㛯	vqkl
㛰	vnaj
㛱	vlge
㛲	vdmy
㛴	vvtq
㛵	vemf
㛶	vmdo
㛸	vfku
㛹	vwgq
㛺	vujg
㛻	vdff
㛼	vtfv
㛽	vpoy
㛾	vdgt
㛿	vgkh
㜀	vshg
㜁	vsjg
㜃	vwyg
㜄	vmtj
㜅	vyxl
㜆	vopy
㜇	vffn
㜉	vvkc
㜊	vnae
㜋	vuwl
㜍	vyvk
㜎	vexd
㜏	vkmy
㜐	vmgu
㜒	vvah
㜓	vawk
㜔	vukq
㜕	vlpy
㜖	vgmj
㜗	vcce
㜘	vhag
㜙	vynx
㜚	vpwj
㜛	vlqw
㜜	vgqt
㜝	vwyg
㜟	vnbt
㜠	vmwy
㜡	vtwh
㜢	vlvg
㜣	vqdo
㜤	vsjh
㜥	vlmy
㜦	vvaf
㜧	vduw
㜨	vnih
㜩	vtmd
㜫	vtmt
㜬	vqdy
㜭	vipl
㜮	vahl
㜯	vaho
㜰	vxrs
㜱	vrrm
㜲	vyny
㜳	vyle
㜴	valh
㜵	vyce
㜶	vqky
㜹	vhhy
㜺	vtfm
㜻	vxyn
㜼	vllg
㜽	vbf
㝷	vavf
㞪	vmj
㣽	vnu
㥨	vffn
㩓	vamr
㪊	vtkc
㪒	vqhc
㪖	vihc
㪢	vhcc
㪩	vfjc
㮣	vcas
㲣	vhcn
㶳	vfho
䀆	vhgl
䀈	vcal
䀌	vfhl
䇒	vcau
䊆	vou
䊠	vcao
䋈	vcxi
䎄	vkng
䎘	vfjn
䎟	vdmj
䎠	vydj
䏋	vinn
䐴	vcae
䑔	vgmh
䑕	vmfh
䑖	vgvh
䑗	vjgr
䑘	vuda
䘫	vkye
䙼	vkhq
䚄	vihq
䝿	vwmu
䢅	vdfe
䢖	vfhp
䢜	vpmp
䣎	vlbh
䥣	vamq
䧱	vwyg
䪳	vtdm
䫀	vcdm
䫮	vakm
䲥	vwvo
䳂	vkwo
䳎	vwvo
䳔	vwvo
䳭	vcbo
䶂	vnuy
䶃	vnun
䶄	vnuh
䶅	vnuk
䶆	vnuy
䶇	vnue
䶈	vnuf
䶉	vnul
䶯	vtxg
䶾	vwqw
㐛	wdkn
㐦	wfgn
㐰	wkg
㐱	wer
㐲	wdy
㐳	wgqn
㐴	wqy
㐵	wgfh
㐶	wnn
㐷	wcg
㐸	wqwy
㐹	wrnn
㐺	wwwy
㐻	wmwy
㐼	wtah
㐽	wmqy
㐾	wfqn
㐿	wrh
㑀	wdyy
㑁	wbmh
㑂	wgmw
㑃	wxln
㑄	wxgu
㑅	wthg
㑆	wkqn
㑇	wqvg
㑈	waiy
㑉	wmgq
㑊	wyoy
㑋	wmag
㑌	wagg
㑍	wdiy
㑎	wvmh
㑏	wpfy
㑐	whiy
㑑	wthg
㑒	wgkw
㑓	wcdc
㑔	wdmy
㑕	wmqy
㑖	wwkh
㑗	wtmt
㑘	waah
㑙	wbnn
㑚	wvfb
㑛	wgki
㑜	wrrh
㑝	wgah
㑞	woah
㑟	wrgw
㑠	wjcf
㑡	wvcb
㑢	wfcb
㑣	wssy
㑤	walg
㑥	wjqr
㑦	wynd
㑧	wtbg
㑨	wktd
㑩	wlqy
㑪	wyjg
㑫	wwyn
㑬	wvdg
㑭	wlgj
㑮	wplh
㑯	wdmy
㑰	wxey
㑱	wcbs
㑲	wfmf
㑳	wqbt
㑴	wvpc
㑵	wutd
㑶	wrno
㑷	wcex
㑸	wdsk
㑹	wgmj
㑺	wwye
㑻	wpnm
㑼	wltk
㑽	wipf
㑾	wqyg
㑿	wvjs
㒀	wumd
㒁	wlff
㒂	wafj
㒃	wafm
㒄	wqdo
㒅	wyqe
㒆	wwgn
㒇	wrlo
㒈	wnbt
㒉	wips
㒊	wvyh
㒋	wadr
㒌	woom
㒍	wcci
㒎	wgdd
㒏	wpfu
㒐	wtqj
㒑	waiy
㒒	wogw
㒓	wfup
㒔	wlqj
㒕	wyxy
㒖	wajy
㒗	waff
㒘	wahu
㒙	wxrh
㒚	wean
㒛	wnwy
㒜	wwfw
㒝	walt
㒞	wmwm
㒟	wyce
㒠	whqg
㒡	weri
㒢	wwga
㒣	wywn
㒤	wbbb
㒥	wdhu
㒦	wllf
㒧	wyby
㒨	wwfn
㒩	wxej
㒪	wahe
㒶	wrf
㓣	wgkj
㓧	wynj
㓱	wgej
㔁	wgkj
㔇	wxmj
㕣	wkf
㖋	wjkx
㖌	wvkx
㖚	wfkx
㘜	wyyk
㙦	wtuf
㚢	wvg
㛜	whtv
㞃	wwkn
㟗	wvwm
㠀	wvgm
㠩	wnqb
㤰	wthn
㥋	wyen
㥐	wgkn
㦛	wfgn
㦰	wwae
㧱	wgkr
㪁	wync
㪉	wgkt
㪘	wgkt
㪧	wgkc
㫦	whtj
㫺	wwwj
㰡	wjqw
㰸	wgkw
㱃	wynw
㲪	wgkn
㲬	wyon
㲻	wiy
㶵	wtfo
㷛	wkso
㷶	wato
㸈	wywo
㸑	wfmo
㸖	wqeg
㸗	wqmk
㸘	wqls
㸙	wqfj
㺱	wegy
㺸	wmyg
㼂	wfgy
㼨	wynn
㼶	wgen
㽂	wgkn
㽅	wgkn
㽇	wfqn
㿯	wgkc
㿽	wgnl
䀺	whth
䁞	wwwh
䁷	wfqh
䋕	wtfi
䎏	wynn
䏌	wef
䑁	wfqe
䒊	wgnc
䖺	whtj
䘀	wnnj
䙚	wvge
䜪	wwkv
䜫	wwka
䜬	wwkm
䜮	wwkh
䜯	wwko
䜰	wwkf
䜱	wwkc
䜲	wwkn
䝇	wqei
䢉	wfte
䢔	wgkp
䢢	wyvp
䣄	wtbh
䣏	wawb
䣸	wtfg
䦾	wnnq
䧶	wyuu
䧻	wgky
䧾	wfky
䨄	wyny
䨇	wywc
䨊	wywg
䩦	whtf
䫛	wntm
䬢	wpvn
䬣	wptn
䬦	wpmc
䬧	wpfq
䬨	wpqv
䬪	wpgi
䬫	wpqy
䬬	wpmd
䬮	wpnw
䬯	wphk
䬰	wpvk
䬱	wpsg
䬲	wpqk
䬳	wpuf
䬴	wpgs
䬵	wpyw
䬶	wpve
䬷	wpqq
䬹	wpgf
䬺	wpud
䬻	wpdy
䬼	wpke
䬽	wpuq
䬾	wput
䬿	wpnn
䭀	wpnp
䭂	wpkc
䭃	wpwn
䭄	wpgh
䭅	wpld
䭇	wpqk
䭈	wpvp
䭉	wpde
䭊	wpad
䭋	wpws
䭍	wpgl
䭎	wpas
䭏	wpya
䭐	wpun
䭑	wpuo
䭒	wptn
䭓	wpmu
䭔	wpwp
䭖	wpyo
䭗	wpuq
䭘	wpji
䭙	wpaj
䭚	wpuf
䭛	wpnt
䭜	wpdi
䭝	wpwj
䭞	wplf
䭟	wpas
䭠	wpyo
䭡	wpen
䭢	wpps
䭣	wpyj
䭤	wpkp
䭥	wpue
䭦	wpaf
䭧	wpyi
䭨	wpmk
䭩	wpyd
䮸	wfqc
䲦	wvgd
䲬	wvga
䲱	wvgy
䲲	wcwo
䲷	wvgs
䲸	wjwo
䳀	wvgw
䳁	wvgc
䳃	wvgb
䳅	wvgw
䳈	wvgn
䳖	wvgn
䳗	wvgt
䳘	wvgt
䳜	wtwo
䳡	wywo
䳧	wvgd
䳫	wgdo
䳰	wkso
䳶	wvgd
䳹	wvgc
䳺	wyno
䳼	wvgk
䳾	wgko
䴋	wvge
䴌	wvge
䵾	wffc
䶳	wgkm
䶵	wgkm
䶿	wyvn
㓜	xvn
㔃	xqcv
㔗	xjln
㔢	xqcl
㔬	xjj
㔭	xjgh
㗽	xtyk
㘘	xyxk
㜷	xgwv
㝀	xgub
㝈	xyxb
㡩	xyxh
㡫	xjqn
㡬	xxdt
㡭	xxgn
㡮	xxdn
㢧	xgd
㢨	xfh
㢩	xqyy
㢪	xfnn
㢫	xmh
㢬	xdcy
㢭	xhcy
㢮	xtbn
㢯	xnan
㢰	xhcy
㢱	xciy
㢲	xxgw
㢳	xtey
㢴	xlry
㢵	xwgk
㢶	xdjg
㢷	xmqy
㢸	xxty
㢹	xuh
㢺	xuvg
㢻	xtvg
㢼	xumi
㢽	xbxn
㢾	xsfg
㢿	xwnd
㣀	xfhw
㣁	xate
㣂	xgkh
㣃	xycx
㣄	xias
㣅	xaqj
㣆	xgwg
㣇	xgrh
㣈	xgrh
㩺	xxfc
㪄	xjty
㪻	xyxf
㫁	xxgr
㯋	xsdm
㱍	xyxw
㽈	xtdn
㽋	xyxn
㿫	xxhc
䊵	xvn
䊶	xbn
䊷	xftt
䊸	xfnn
䊹	xtfh
䊺	xgxg
䊻	xqwy
䊼	xhg
䊽	xnwy
䊾	xsy
䊿	xfwy
䋁	xymn
䋂	xqqy
䋃	xtfn
䋄	xmqy
䋅	xrhh
䋆	xynt
䋇	xnyy
䋉	xpwy
䋊	xghg
䋋	xnan
䋌	xang
䋍	xskg
䋎	xjgg
䋏	xthf
䋐	xant
䋑	xgmw
䋒	xcbt
䋓	xqvg
䋔	xgig
䋖	xvfh
䋗	xahh
䋘	xdiy
䋙	xbg
䋚	xng
䋛	xoy
䋝	xivg
䋞	xmqq
䋟	xnny
䋠	xgey
䋡	xwty
䋥	xjfg
䋦	xtxu
䋧	xndg
䋨	xukg
䋩	xvqn
䋪	xbsk
䋫	xqvh
䋬	xgdn
䋭	xyce
䋮	xqg
䋱	xsww
䋲	xkjn
䋳	xuxe
䋴	xcbs
䋵	xjqn
䋶	xdmy
䋸	xrfh
䋹	xgkl
䋺	xtoy
䋻	xfmf
䋼	xecl
䋽	xfff
䋾	xdqq
䋿	xlge
䌀	xtuf
䌁	xsvg
䌂	xngf
䌃	xiej
䌄	xgmc
䌅	xyvk
䌆	xrqc
䌇	xfpi
䌈	xjng
䌉	xlgh
䌊	xerm
䌋	xawk
䌌	xnrg
䌍	xakg
䌏	xpnm
䌐	xehq
䌑	xahf
䌒	xynx
䌔	xakk
䌕	xyss
䌖	xwys
䌗	xrlo
䌙	xamw
䌚	xsoy
䌜	xogw
䌝	xssi
䌞	xwgw
䌟	xnku
䌡	xmau
䌢	xfwc
䌣	xtpn
䌤	xgwq
䌥	xean
䌦	xnwy
䌧	xfnf
䌨	xawi
䌩	xalt
䌪	xuqv
䌫	xahq
䌬	xued
䌭	xawo
䌮	xfsh
䌯	xaky
䌰	xbbb
䌱	xyny
䌲	xato
䌳	xgwy
䌴	xyny
䌵	xnij
䌶	xftt
䌷	xmg
䌸	xfny
䌹	xmkg
䌺	xbg
䌻	xng
䌼	xukq
䌽	xesy
䌾	xfmf
䌿	xgkl
䍀	xjtl
䍁	xuep
䗍	xeju
䗽	xwyj
䘡	xxye
䜌	xyxy
䥒	xkjq
䥸	xgwq
䫜	xxmm
䭫	xjuh
䭬	xjvh
䰜	xgkx
䰞	xfth
䳇	xguo
㐎	ynb
㐔	ynb
㐣	ylnv
㐧	ynht
㐪	ybwu
㐫	ybk
㐬	ycqb
㐭	ylkf
㐯	yktj
㓙	ybk
㓪	yvcv
㓲	ynmj
㔊	ylkj
㕻	yikf
㖜	ykxb
㖱	ywtk
㙜	ymkf
㙶	yipf
㚆	yjtu
㝄	ybgn
㝇	ybyb
㠵	ynmh
㡯	ytav
㡰	ygfk
㡱	yqyi
㡲	yae
㡳	yqav
㡴	yud
㡵	ywyc
㡶	ykwi
㡷	ysgd
㡸	ythf
㡹	yegd
㡺	yjgd
㡻	yqtb
㡼	yjxe
㡽	yvfh
㡾	yvei
㡿	yubt
㢀	ygmi
㢁	yqqi
㢂	ywnn
㢃	yyve
㢄	ygku
㢅	ygak
㢆	yjfd
㢇	yyd
㢈	ywyd
㢉	ytta
㢊	ydsk
㢋	ywqq
㢌	ybsk
㢍	yamd
㢎	ytfv
㢏	ywgj
㢐	ymnk
㢑	ywyf
㢒	yhag
㢓	yujk
㢔	ytwh
㢕	yxty
㢖	ytol
㢗	ytdk
㢘	yuvo
㢙	yakl
㢚	yhal
㢛	ywgw
㢜	yaln
㢝	yqot
㢞	ynlw
㣑	yvee
㥷	ydwn
㦄	yssn
㦾	ynbv
㦿	ynsi
㧀	yney
㧁	ynfc
㧂	ynld
㪐	yndc
㪟	yjty
㪣	ymkt
㪯	yfhj
㪰	you
㪱	yqmd
㫂	yaor
㫃	ywy
㫅	ywfj
㫆	ywiy
㫇	ywun
㫈	ywuk
㫉	yqdb
㫊	ytsk
㫋	ytmf
㫌	ytgh
㫍	ytwt
㫎	ytpl
㫏	ytsv
㮾	yvcs
㰠	ymqw
㰵	ywww
㱂	yviw
㱾	yntc
㲞	ywwn
㲢	ynmn
㲤	ykgn
㲥	yvhn
㸏	ysso
㻾	yxty
㼐	ynmy
㼚	ymgn
㼺	yvhn
㼾	ynjn
㽫	yxtl
䁈	ynth
䁉	ynah
䃞	ybvd
䃦	ybtd
䇔	ynky
䊨	ynkm
䋀	ynxi
䋜	ynci
䋯	ynai
䏿	ynte
䐡	ymww
䖟	ynju
䗐	ytbj
䗠	ytnj
䗪	yaoj
䗸	yxtj
䘇	yjjj
䘚	yefj
䙝	yfue
䚮	yen
䚯	yjh
䚰	yxn
䚱	yiy
䚲	yet
䚳	yfcy
䚴	yeg
䚵	yufh
䚶	ygdy
䚷	ywgn
䚸	ywjh
䚹	yxxn
䚺	yty
䚼	ynfg
䚽	ytfn
䚾	ytfg
䚿	yqwy
䛀	yrcy
䛁	ymfg
䛂	ytah
䛃	yfqn
䛄	yqbn
䛅	ylh
䛆	ymg
䛇	ymkg
䛈	ytdy
䛉	ynan
䛊	ykwy
䛋	ydnt
䛌	yqnn
䛍	yxjh
䛎	ypwy
䛏	ynxn
䛑	yntt
䛔	ydmj
䛕	yjqy
䛖	yjnt
䛖	yjxt
䛘	ywtf
䛙	ywsy
䛛	ylkg
䛜	ytlq
䛝	ynfm
䛞	yjfh
䛟	ydww
䛠	ygku
䛡	yqak
䛢	ytmn
䛣	ymgn
䛤	ykhy
䛥	yqdh
䛦	ywwk
䛧	yonn
䛨	yuh
䛩	ygfg
䛪	ypwx
䛫	ydey
䛬	yqrm
䛭	yfuf
䛮	ythk
䛯	yndg
䛰	yjxx
䛱	ykhn
䛲	yrmh
䛳	ydjn
䛴	ydsk
䛵	yepc
䛶	ydhs
䛷	ypqb
䛸	yyhk
䛹	yxey
䛺	ylwj
䛻	yrfh
䛼	yvag
䛽	ytfv
䛾	ygxi
䛿	ygkh
䜀	yvyh
䜁	yffd
䜂	yrdf
䜃	ywyf
䜄	ynih
䜅	ymwy
䜆	yssy
䜇	yuce
䜈	yvjs
䜉	yswi
䜊	ygmj
䜋	ykhm
䜍	ydui
䜎	yool
䜏	ybde
䜑	ygfn
䜒	ytmd
䜓	yaas
䜔	ydap
䜕	yajy
䜖	ysmy
䜗	ydgn
䜘	yaqt
䜙	yjxo
䜚	ylip
䜛	yqkq
䜜	yhph
䜝	yxxn
䜞	yyjg
䜟	yfag
䜠	yrrm
䜡	ydet
䜢	ypdn
䜣	yrh
䜤	yawy
䜥	yjgp
䜦	yaqj
䜧	yvyh
䜨	ykkn
䜩	yako
䝺	yymu
䞄	ytbm
䢍	ypv
䢟	ytpi
䢦	yxip
䣌	yqab
䥆	ydjq
䧹	ywwy
䨾	ydjd
䫯	ydsm
䯢	ysse
䯧	ypmk
䯨	ymkd
䯩	ymkc
䯪	ymkm
䯬	ylkf
䲳	ymwo
䲻	yxwo
䳸	ysso
䴟	ynjy
䴠	ynjd
䴢	ynjs
䴣	ynjh
䴤	ynjg
䴥	ynjk
䴦	ynjy
䴧	ynjv
䴨	ynji
䴩	ynji
䴪	ynji
䴫	ynjc
䵇	ysst
䵉	yssj
䶒	yfvj
