---config@码表分类=主码-8
---config@码表别名=CJKExt_G
𰀂	agd
𰀄	agd
𰀋	atkk
𰁕	aff
𰃃	aflu
𰃬	amhn
𰅅	aflj
𰅤	ati
𰅥	afnd
𰅦	aijf
𰅧	ashd
𰅨	alrk
𰅩	avwm
𰅩	aqgm
𰅪	afci
𰅫	aqbk
𰅬	akhc
𰅲	anfj
𰅽	adwy
𰈑	adwx
𰉸	aqaf
𰊶	ajmf
𰋚	ady
𰋝	andu
𰋱	awgd
𰌀	apvf
𰎊	avmj
𰏈	aay
𰏉	agnv
𰏊	adcy
𰏋	adkg
𰐎	ajfy
𰐏	aqey
𰐐	ayyi
𰐑	anry
𰐒	awwy
𰑋	annu
𰑟	amnu
𰒥	aak
𰒦	atui
𰒧	aqci
𰒩	ajk
𰒫	agbj
𰒭	amjk
𰒯	aooa
𰒲	akgg
𰓛	ajrj
𰕅	aqhc
𰕉	atdc
𰕢	agkr
𰕦	ajdr
𰗐	aii
𰗔	ahts
𰘓	apss
𰙅	ahns
𰚖	awtn
𰞯	awxo
𰟑	awdo
𰟝	aflo
𰟱	akko
𰠠	ahth
𰠡	ahtw
𰠢	ahtk
𰠤	ahtk
𰠥	ahtm
𰢧	afnu
𰢨	afeg
𰢩	affx
𰢪	adwp
𰤯	adwc
𰥞	aphf
𰦎	acbt
𰦷	apdf
𰧣	adwd
𰫱	ahnn
𰫻	akkx
𰭸	abbf
𰮕	afmw
𰯮	ahnn
𰯯	ahnc
𰯰	ahnc
𰯱	ahnr
𰯲	ahnl
𰯳	ahnh
𰰊	aiqh
𰰜	afj
𰰟	annb
𰰠	agng
𰰡	apgf
𰰢	anrr
𰰤	aaqu
𰰥	abth
𰰧	aeu
𰰨	awxb
𰰩	aufj
𰰪	anhf
𰰫	agcu
𰰬	agou
𰰭	akcu
𰰮	ajvf
𰰯	awbn
𰰰	aqtb
𰰱	acfu
𰰲	aajj
𰰳	ajgh
𰰴	amnb
𰰵	aqsu
𰰶	avsu
𰰷	aqmu
𰰸	aixb
𰰹	ayjj
𰰺	aymc
𰰻	aivf
𰰼	aigh
𰰽	apwx
𰰾	afpu
𰰿	adlj
𰱀	aamu
𰱁	adqb
𰱂	agaj
𰱃	aatd
𰱄	anhn
𰱅	aksu
𰱆	atff
𰱇	auef
𰱈	apfi
𰱉	aunu
𰱊	ayig
𰱌	axmw
𰱍	axwv
𰱎	abtu
𰱏	aajf
𰱐	afnd
𰱑	alrj
𰱒	aasu
𰱓	asym
𰱔	ahef
𰱖	atyg
𰱗	apuv
𰱘	aorj
𰱙	aoqc
𰱚	aipb
𰱛	axtu
𰱜	axtd
𰱝	aadm
𰱞	aght
𰱟	afam
𰱠	afna
𰱡	aafw
𰱢	akhj
𰱣	aktk
𰱤	amww
𰱥	ackn
𰱦	atjt
𰱧	atym
𰱨	aogh
𰱩	aukk
𰱪	ayne
𰱫	asgf
𰱬	arie
𰱭	anuq
𰱮	ahan
𰱯	alfc
𰱰	ajit
𰱱	auqm
𰱲	abkw
𰱳	araj
𰱵	apww
𰱶	abcn
𰱸	abco
𰱹	akkt
𰱺	awgn
𰱻	atye
𰱼	ayuk
𰱽	asug
𰱾	agkm
𰱿	agkp
𰲀	ajdf
𰲁	atmm
𰲂	aeug
𰲃	awyl
𰲄	auah
𰲅	ayhg
𰲆	aipk
𰲇	avku
𰲈	aymt
𰲉	aiak
𰲊	aakw
𰲋	afcy
𰲌	asjc
𰲍	ajdj
𰲎	aesy
𰲏	ayjd
𰲑	awyj
𰲒	aodm
𰲓	awnn
𰲔	akhh
𰲕	atei
𰲖	akkk
𰲗	agkg
𰴛	anfq
𰴯	apyf
𰷞	aymu
𰺅	awlj
𰺯	apk
𰺴	aqpv
𰺷	atgp
𰻍	avgp
𰻗	afup
𰻨	aibh
𰻲	amgb
𰽈	admq
𱁱	afnr
𱁲	afpm
𱁳	afch
𱁴	afxf
𱁵	aflp
𱁶	aftp
𱁷	affd
𱁸	afak
𱁹	afkm
𱁺	afov
𱁻	afay
𱁼	afpk
𱁽	afui
𱁾	afai
𱂣	atgm
𱂴	amfm
𱃇	ansj
𱅽	aqkk
𱉀	alno
𱉅	adwo
𱉪	aqqg
𱊠	awgg
𱊴	akug
𱋲	amwg
𱋳	agmk
𱋴	amwf
𰀋	alk
𰃃	aflt
𰀬	bnwu
𰀱	bbb
𰀸	bbb
𰁒	bbh
𰃋	bkqb
𰄔	bmbm
𰄕	bmdb
𰄘	bmyb
𰆊	bnh
𰆋	bbh
𰆲	bhgc
𰆼	bcbc
𰌚	bmyv
𰌜	bftt
𰌝	btan
𰌟	bfcy
𰌠	bhf
𰌡	bhcy
𰌢	bnhf
𰌣	btdy
𰌤	bwyc
𰌥	bpsh
𰌦	bgog
𰌧	bdmj
𰌨	bieg
𰌪	badw
𰌫	bdfi
𰌬	bjhg
𰌭	bute
𰌯	blxi
𰎈	bwch
𰒌	bqbn
𰔄	bdir
𰕖	bkgt
𰖆	bigj
𰙳	btah
𰚶	bbbn
𰞜	bigo
𰟹	bueo
𰠽	bdy
𰢒	bjgy
𰥜	bmhg
𰭳	btcy
𰭴	bdny
𰭵	bghn
𰭷	btfh
𰭹	bdxy
𰭻	bdmj
𰰞	btbq
𰳄	baij
𰸷	bwnh
𱀃	bgmh
𱀄	bwcy
𱀆	bdg
𱀇	bty
𱀊	bpvn
𱀋	bffg
𱀌	bfhg
𱀍	bdgf
𱀎	bdyy
𱀏	bwhg
𱀐	bqnn
𱀑	bitc
𱀒	bmit
𱀔	bppy
𱀕	bcic
𱀗	bajg
𱀙	bmeh
𱀚	btvg
𱀛	bwfk
𱀞	bpqa
𱀡	bfam
𱀢	bdeb
𱀣	bjgh
𱀤	bjwv
𱀦	brhg
𱀧	bqaf
𱀨	boah
𱀩	bbkb
𱀪	bamf
𱀫	bcim
𱀬	bswf
𱀭	bghg
𱀯	bpgw
𱀰	byle
𱀱	bfwj
𱀲	baqq
𱀴	bmdm
𱀵	busf
𱀶	buvo
𱀷	bfup
𱀸	bftf
𱀹	bbbu
𱀺	bkhk
𱀻	bawc
𱀼	bhay
𱀽	bhay
𱀾	bwur
𱀿	byup
𱁀	bden
𱁁	bbcc
𱁂	buei
𱁐	bmwy
𱂍	bwhg
𱂏	bujf
𱂢	bmdm
𱂰	bibm
𱉉	bqyg
𰅐	bllf
𰌢	bnfg
𱀥	bvhc
𱀹	bbbn
𰃟	cwi
𰆭	cwyu
𰆮	cdfq
𰆳	cwxn
𰆶	cvhh
𰆷	cdnj
𰆻	cffg
𰆽	ccqc
𰇁	cyce
𰇃	ccci
𰇅	cdmh
𰇆	cccc
𰇍	cckf
𰉿	cqof
𰍥	cjff
𰑀	chnu
𰑈	cnu
𰑉	cbnu
𰕇	caty
𰗑	csu
𰚮	cbtn
𰢳	cety
𰤳	clf
𰦍	cbty
𰦏	cbtt
𰦏	cbty
𰦐	cbtx
𰦑	cbtq
𰯋	cwyw
𰯠	ckww
𰴨	cyf
𰴸	cqwy
𰶺	cmng
𰹞	cccl
𰼪	crhq
𰼪	ctrq
𰼫	cccq
𱄑	ccu
𱄓	cann
𱄔	clng
𱄘	ckfg
𱄛	cdiy
𱄜	ccnf
𱄞	cffn
𱄟	cann
𱄠	ctxi
𱄥	ctay
𱄧	cujg
𱄬	crvc
𱄲	cghn
𱄲	cgon
𱄳	cfww
𱄹	cfhj
𱄼	caj
𱄽	ctan
𱄾	cyt
𱄿	ccg
𱅁	ckhj
𱅂	ceyy
𱅃	cang
𱅄	cdcy
𱅇	cwet
𱅈	cnty
𱅉	cadt
𱅋	cbg
𱅌	cuxg
𱅍	cdyy
𱅍	cdyt
𱅎	cwdy
𱅏	cqiy
𱅐	cuqy
𱅒	cccg
𱅓	cfpb
𱅔	cgki
𱅕	cgoy
𱅖	ckeg
𱅗	ctry
𱅗	ctrt
𱅘	cusy
𱅙	cukq
𱅚	cwfk
𱅛	cujf
𱅜	csvg
𱅞	cnhc
𱅟	ccbs
𱅡	crqc
𱅢	ctux
𱅣	cevg
𱅤	cprw
𱅥	cpge
𱅦	camw
𱅧	chag
𱅨	ccbl
𱅩	cnrg
𱅪	csjh
𱅫	ccbk
𱅬	cauo
𱆦	cqoi
𱆫	cfqo
𱈥	ckwo
𱉟	cfhg
𱉠	caqg
𱉡	caqg
𱉲	crhg
𱉲	ctrg
𱉾	cwtg
𱊍	cccg
𱊗	cbtg
𱄒	crh
𱄕	cwbn
𱄖	cqbh
𱄗	cpm
𱄙	cuxg
𱄚	chjg
𱄝	cdqn
𱄡	cwwf
𱄢	ccic
𱄣	cqfh
𱄤	cvwy
𱄥	ctgw
𱄦	cqbc
𱄨	cpgg
𱄩	cgxi
𱄪	csny
𱄫	cdkk
𱄭	cqbl
𱄮	chgu
𱄯	cmjj
𱄰	cewn
𱄱	cqjg
𱄲	cgfn
𱄵	cdvh
𱄶	cqmq
𱄷	cjan
𱄸	ctqn
𱄺	ctwl
𱄻	cqbo
𱅆	cdkg
𱋥	cbtt
𰄨	dahj
𰄬	dpjh
𰄴	djnv
𰄾	dwwj
𰅣	dqux
𰅳	dufj
𰅶	dcb
𰆓	dwwy
𰆕	dyqi
𰆖	dfqv
𰆗	dyi
𰆘	dtgd
𰆙	dgoi
𰆚	dwgg
𰆛	dfyn
𰆜	dhic
𰆝	djye
𰆟	doed
𰆠	dfve
𰆡	dffw
𰆢	dffc
𰆣	dffc
𰆤	drvc
𰆥	dujn
𰆦	dxxv
𰆧	dqik
𰆨	dawu
𰆩	drde
𰆪	dafd
𰆫	dfyl
𰆬	drii
𰇤	dkxb
𰈖	djdx
𰉒	dwwk
𰉧	ddfd
𰉯	dnnf
𰊎	dhfk
𰋁	depf
𰋊	djfw
𰋛	dtay
𰋜	dqqi
𰋞	dghf
𰋠	dwgn
𰋤	dhhc
𰋦	dwwy
𰋲	dhna
𰋳	dccg
𰋽	ddvd
𰍛	dqpn
𰍮	dnpv
𰏇	dann
𰏌	dasg
𰏍	damf
𰏡	dmhn
𰑕	ddni
𰑜	dnnn
𰒮	dyni
𰒳	dynd
𰓙	ddrk
𰕄	dty
𰖫	dwge
𰗈	dede
𰗏	defq
𰗜	ddsi
𰘾	ddds
𰚩	dfen
𰛖	duiu
𰝽	dnyo
𰞈	douf
𰞴	djdo
𰟥	duro
𰟶	doae
𰡈	degg
𰣠	djnh
𰣱	dndd
𰤁	dndl
𰤅	dndy
𰤊	dndd
𰤭	dufc
𰤰	dujc
𰤶	dulf
𰥎	dhf
𰥖	dwhf
𰦤	dbyy
𰦥	drcy
𰦦	ddlt
𰦧	dgxg
𰦨	dyly
𰦩	dynt
𰦪	dngg
𰦫	dccu
𰦬	dccy
𰦭	ddxy
𰦮	dvlt
𰦯	dhhy
𰦰	dcfh
𰦲	dcfy
𰦳	dbg
𰦴	dgog
𰦵	ddfy
𰦶	dgjg
𰦸	djh
𰦹	dvg
𰦺	dytc
𰦻	dgkc
𰦼	dfpb
𰦽	dgty
𰦾	dgod
𰦿	dkmw
𰧀	djah
𰧁	dkkh
𰧃	dujg
𰧄	dykg
𰧅	dhch
𰧆	ddfa
𰧇	djcm
𰧉	drfm
𰧊	dpjh
𰧌	dmjj
𰧍	drhs
𰧍	dtrs
𰧎	dqqw
𰧏	duej
𰧐	dgng
𰧒	djng
𰧓	daps
𰧔	djtl
𰧕	dwyk
𰧗	dtgf
𰧘	dyfj
𰧙	dipf
𰧚	dlub
𰧛	dmdf
𰧜	dmyt
𰧝	dwvm
𰧞	dqjg
𰧟	dypy
𰧡	dgjl
𰧢	dfwj
𰧤	dtvg
𰧥	dtff
𰧦	dwwj
𰧧	duvo
𰧨	dcfs
𰧩	dfoo
𰧪	dfwm
𰧫	dqky
𰧬	dwnh
𰨩	dhty
𰭣	dtfn
𰭩	dftx
𰭱	diwj
𰭲	dilf
𰭿	dmww
𰯖	dubw
𰲴	dxyj
𰳀	depj
𰳧	dtld
𰳳	dmhe
𰶝	djdu
𰷍	dndm
𰺭	dfec
𰺾	djnp
𰻒	dkkp
𰻧	dkcb
𰿌	dcwv
𰿎	dcdj
𰿏	dejf
𰿐	dcyq
𰿑	dcqk
𰿒	dctm
𰿓	dcgf
𰿕	dcce
𱁍	dwwn
𱁰	dmjr
𱂘	dsdm
𱂱	dgkm
𱅅	dxyg
𱅿	delk
𱆀	deuj
𱆁	deue
𱆂	dejg
𱆃	dekm
𱆄	dexm
𱆅	dejl
𱆆	deaw
𱆇	dedi
𱆈	detm
𱆛	dtfc
𱈺	dwwo
𱊁	dskg
𱊧	dubg
𱍁	dxya
𱍂	dxyy
𱍃	dqjn
𰃍	diq
𰆝	djyv
𰆞	dvvv
𰆠	dfye
𰆧	diqk
𰋊	djfm
𰋢	dllt
𰧈	dalw
𰧖	dqsc
𰿌	dwvn
𰿎	ddjg
𰿑	dqfk
𰿒	dtrm
𰿓	dghg
𰿔	deyi
𰆵	eyfk
𰙟	eyhf
𰀝	egeg
𰀯	eiye
𰁂	egln
𰁑	ebtn
𰅘	egli
𰆎	ebyy
𰇂	ebcu
𰉼	eeff
𰋴	exdd
𰐩	eet
𰒖	eedn
𰕊	ebty
𰗅	ejnn
𰗇	etds
𰗉	eyiy
𰗊	edpy
𰗌	eghy
𰗍	eujh
𰗎	eada
𰙔	eskw
𰙗	evqw
𰞧	efou
𰟾	emwc
𰟿	epef
𰠀	eksu
𰠂	efjr
𰠄	eywf
𰠆	ecma
𰠈	efuw
𰠉	exkf
𰠊	exxf
𰢱	eheh
𰤜	eerf
𰩧	edmu
𰭟	eyng
𰮁	evt
𰮃	eiy
𰮅	extt
𰮇	efqn
𰮊	erhh
𰮋	ewmn
𰮐	epmn
𰮒	eang
𰮓	eafy
𰮙	eqvg
𰮚	eeiy
𰮝	eatq
𰮟	edah
𰮠	eqdc
𰮡	egmw
𰮤	eufw
𰮤	eudw
𰮥	effn
𰮦	efay
𰮩	eqtd
𰮬	ehwy
𰮭	ekjn
𰮯	erny
𰮰	erpy
𰮱	eqre
𰮲	evij
𰮳	eblg
𰮵	efyw
𰮷	eadk
𰮸	emjh
𰮺	ekhe
𰮼	eqkx
𰮽	etjg
𰮾	epoc
𰮿	echc
𰯀	ebkb
𰯁	egdj
𰯂	ejtl
𰯃	emth
𰯄	ekkh
𰯅	eaqj
𰯈	eudr
𰯉	eybg
𰯊	ecbi
𰯌	edwn
𰯍	efnn
𰯎	eagw
𰯏	eags
𰯐	eqjg
𰯒	evne
𰯓	evqc
𰯔	enbt
𰯕	efln
𰯗	eipr
𰯘	eqly
𰯙	eudf
𰯚	eooo
𰯛	eyoj
𰯝	evvh
𰯞	eldf
𰯟	ebdp
𰯡	eaiy
𰯢	eukk
𰯤	euqj
𰯧	eyuo
𰯨	eyle
𰯩	eyky
𰯪	enwc
𰯫	edhh
𰯬	ellx
𰴝	ecmq
𰴱	eycy
𰺮	ehhi
𰺵	ehhd
𰺼	ehge
𰻃	epcp
𰻈	ehtf
𱄴	eudc
𱉒	eqyg
𱉘	egqg
𱉺	ebqg
𱉻	evqg
𱊒	eftg
𱊓	eyng
𱌦	eevb
𰀬	enwu
𰅮	efj
𰆾	eyud
𰇮	eywk
𰗋	eevg
𰩕	eypf
𰮹	ekhf
𰯑	eyvi
𰶪	esjg
𰶫	eawc
𰶭	ebde
𰶮	etup
𰶰	efkw
𰺼	ehey
𰶤	exn
𰶥	ebh
𰶦	etdy
𰶨	eemq
𰶬	eovg
𰀞	flnf
𰁁	fhnb
𰁖	fwhj
𰁗	fnyu
𰁙	fmhw
𰁛	fcjc
𰁤	fqwi
𰃏	fqtf
𰄞	fnyj
𰄠	fcvt
𰄳	fjgv
𰄿	fpgv
𰅉	fjlt
𰅑	fjll
𰅡	ftxn
𰅰	fmhg
𰅴	fmdu
𰅷	fvhg
𰅸	fdey
𰅹	fmhc
𰆀	fmuf
𰆂	fmuf
𰆑	ftyb
𰆯	fcjf
𰇔	fwkx
𰈀	fhkx
𰈷	ftyx
𰈺	fkuk
𰉇	fkue
𰉕	fnb
𰉖	fan
𰉘	ffnh
𰉙	fmqy
𰉚	fmqn
𰉜	fwyn
𰉝	ftfn
𰉞	fxhh
𰉟	fuxn
𰉠	ftdc
𰉡	ftuy
𰉣	fcfh
𰉥	fgud
𰉦	fdeg
𰉨	fbgh
𰉩	ftdj
𰉪	fwxf
𰉫	fwqb
𰉬	fmgq
𰉭	fqjf
𰉮	fgki
𰉰	ffmd
𰉱	fwgg
𰉲	fqkq
𰉳	frfh
𰉵	fntn
𰉶	fikg
𰉷	fdfg
𰉺	fqoy
𰉻	fepc
𰉽	fipb
𰉾	fywy
𰊁	fsry
𰊂	fgkh
𰊃	fglg
𰊄	fith
𰊅	fqku
𰊆	ftdi
𰊊	fuxx
𰊋	fnut
𰊌	fnaf
𰊍	ffke
𰊏	fdns
𰊐	flqt
𰊑	fjtl
𰊒	fana
𰊓	fljn
𰊔	fthn
𰊕	fomk
𰊗	fpwf
𰊘	fbti
𰊙	fpgf
𰊚	fakw
𰊛	fakm
𰊜	fgmy
𰊝	ffhs
𰊞	fhmk
𰊟	fagw
𰊠	fiph
𰊡	fuqv
𰊥	fukg
𰊦	ffkk
𰊧	ffhs
𰊨	fusy
𰊫	ftvg
𰊬	fwgn
𰊮	fwgl
𰊰	fthu
𰊱	fyin
𰊳	fffd
𰊴	flfg
𰊵	fwyu
𰊷	fxg
𰊸	fydt
𰊹	fddm
𰊺	fipj
𰊻	fflm
𰊼	fhae
𰊾	fmlo
𰋀	fxxl
𰋂	fayc
𰋃	fyoc
𰋄	fnlw
𰋅	ftif
𰋆	fipo
𰋇	fffs
𰋈	fphu
𰋉	fffg
𰋋	fkuu
𰋌	fnga
𰋍	fpmf
𰌌	fkuv
𰌘	fkuv
𰌞	fwbf
𰌲	ftbp
𰏞	fufh
𰏢	fmh
𰏩	fkuf
𰏮	fufo
𰐠	fqxf
𰐢	fqyp
𰑲	fwtn
𰑴	fjfn
𰒍	fpkn
𰔕	fpgr
𰕀	fcvv
𰕁	fcvf
𰕂	fcuh
𰘉	file
𰘦	fiyf
𰘨	fffs
𰙍	fpcw
𰙦	fahd
𰚃	fkuc
𰚈	fpfc
𰚉	fpkc
𰚵	fadn
𰚸	fcna
𰝸	ftou
𰞊	ffoy
𰟚	fufo
𰟞	fffo
𰟴	ftyi
𰢢	fqgy
𰣋	fwwl
𰤚	fwfr
𰤬	fnuc
𰥃	fnwl
𰥈	fhlb
𰥑	fhhg
𰥺	fhwf
𰥾	foth
𰦂	fnhh
𰦌	fhww
𰧋	fpdt
𰧭	ffiu
𰧸	fafi
𰨵	fmum
𰭧	ftnv
𰭨	ftgf
𰭫	ftxr
𰭬	fdmj
𰮶	fmuw
𰰎	fjte
𰱴	fwad
𰲠	fahq
𰳎	fjfj
𰳤	fffh
𰴒	fhqn
𰴓	fhwq
𰶘	fwgu
𰶟	fnwu
𰶱	fhwu
𰷌	fakm
𰷎	fnwm
𰷣	fwfm
𰷦	fcxm
𰷰	fook
𰷱	fhgg
𰷲	fhtn
𰷴	fhti
𰷵	fhaq
𰷶	fhtj
𰷷	fhei
𰷸	fhfd
𰷹	fhss
𰷺	fhhm
𰷼	fhdk
𰷽	fhql
𰷾	fhgy
𰸀	fhfc
𰺘	fnml
𰺻	fnpi
𰻀	ffhp
𰻡	fqbh
𰻪	ftmb
𰼂	fkkb
𰿦	fub
𱁑	fxb
𱁒	fcfu
𱁓	fxvr
𱁔	ffyr
𱁕	fffn
𱁖	fjcf
𱁗	flwu
𱁘	flln
𱁙	fitd
𱁚	fbyr
𱁛	fgji
𱁝	fbcu
𱁞	fujf
𱁟	fyce
𱁠	fjnc
𱁡	ftth
𱁢	fiwf
𱁣	fvpg
𱁤	flnh
𱁥	ffch
𱁦	fmjr
𱁧	fqtx
𱁨	fptl
𱁩	fimu
𱁪	fllf
𱁫	fwyy
𱁬	ffcd
𱂃	fnhy
𱂄	fnhi
𱂅	fnht
𱂆	fnhk
𱂈	fnhl
𱂉	fnhe
𱂊	fnhs
𱂋	fnhj
𱂌	fnhc
𱂪	fmdm
𱃃	fqtj
𱅠	fjwc
𱆢	fkkc
𱈩	ftbo
𱈻	fwfo
𱈼	fpgo
𱈿	fpgo
𱉊	fqyg
𱉎	fwqg
𱉏	fnyg
𱉤	ffqg
𱉥	fkqg
𱉦	ftxg
𱉧	faqg
𱊀	fwfg
𱊚	fhwg
𱊦	fpgg
𱊪	fwyg
𱋞	fpgc
𱋻	fcqx
𱋾	fwkn
𱋿	fckn
𱌃	ffkn
𱌊	fkuy
𱌋	fkuk
𱌌	fkuj
𱌟	fffb
𱍀	fwgd
𰉴	fpwl
𰐢	fwfp
𰒘	fnmn
𰟴	ftji
𰥃	fnml
𰩌	fcpl
𰩩	fnmu
𰭫	ftxq
𰶟	fnmu
𰷎	fnmm
𱁘	fllb
𱁜	fbmb
𱁧	fqtu
𱃃	fwtj
𰀘	gipw
𰀚	gigt
𰀲	ginb
𰆱	gicy
𰒤	giat
𰒤	giay
𰴪	giyf
𰿖	gity
𱉖	gigg
𰀀	gnv
𰀁	gggh
𰀃	gmb
𰀆	guf
𰀇	gngn
𰀈	gcu
𰀉	gkhk
𰀌	gkmh
𰀐	gtfc
𰀒	gmww
𰀕	gmww
𰀖	glag
𰀙	gdya
𰀛	gjjf
𰀟	gigh
𰁓	gcqh
𰁔	ghqh
𰁘	gfqg
𰁚	gfga
𰃛	gkuy
𰄭	gmyj
𰄯	gojh
𰅆	gmif
𰅕	gmal
𰇿	gkux
𰈟	gdkk
𰈫	gvkd
𰉛	gdff
𰋟	gdgd
𰋡	gdqb
𰋨	grdu
𰋩	gdgd
𰋪	gdru
𰋭	gdjg
𰋮	gdfn
𰋯	gdyy
𰍎	gcph
𰍭	gqtg
𰏅	gvab
𰏚	gkpt
𰏦	guff
𰏨	guft
𰐊	gqja
𰑨	gfqn
𰑵	gkpn
𰒜	gogi
𰒝	gkit
𰒪	gkua
𰕃	gnhc
𰕏	gmwt
𰙇	gkii
𰙉	gogo
𰙖	glkw
𰙛	ghsh
𰙠	gmwh
𰙤	ghgh
𰙴	gkmh
𰙸	ghuj
𰙼	gqdg
𰙽	gqfg
𰙾	gqwg
𰙿	gqhh
𰚀	gquh
𰚁	gquj
𰚂	gqgm
𰚏	gitn
𰚞	gmhn
𰚰	gotn
𰛕	gjii
𰞁	gmwo
𰞡	gkio
𰡭	gvn
𰡮	gufd
𰡯	gay
𰡰	glh
𰡱	gmwy
𰡳	gywu
𰡴	gghg
𰡵	ghnt
𰡶	ghhy
𰡷	ggqb
𰡹	gtlq
𰡺	gdiy
𰡻	gyqb
𰡼	gbsy
𰡽	gdtf
𰡾	gevg
𰡿	gymh
𰢀	gqgg
𰢁	gwwg
𰢂	gmoy
𰢄	gvij
𰢅	ggkl
𰢆	ggwh
𰢇	ggwi
𰢈	gtgf
𰢉	ghay
𰢊	gygy
𰢋	gakk
𰢌	ggwi
𰢎	gtqs
𰢏	gdmj
𰢐	ghhh
𰢑	gqgj
𰢓	gmau
𰢔	gtjn
𰢕	ghls
𰢖	gkgh
𰢗	gjaf
𰢘	gysd
𰢙	gwga
𰢚	gbbb
𰢣	gnna
𰢴	glf
𰣕	gklj
𰣝	gklj
𰤣	gchc
𰤽	gqfl
𰧑	gqtd
𰲸	gogj
𰳋	gqwj
𰴗	gmyq
𰴭	glwy
𰶗	gkun
𰶙	gkuo
𰶜	gkuq
𰶞	gkuy
𰶠	gkub
𰶡	gkul
𰶢	gkun
𰶧	gbcu
𰷆	gtmu
𰸛	gkph
𰺬	gumu
𰺰	gqpv
𰺿	gjhp
𰻆	gkpp
𰻖	gaop
𰻛	gefp
𰻢	ghnb
𰻣	gbnc
𰻴	glkb
𰼛	golf
𰼵	gqaq
𰼶	gmiq
𱁭	gepp
𱁮	gevc
𱂚	gkmm
𱂩	gehm
𱄌	gauh
𱅸	ghyk
𱆌	gkmr
𱆍	gkmv
𱆏	gkmo
𱈭	gewo
𱉍	gqyg
𱉨	gogg
𱉩	gxwg
𱉵	goqg
𱊏	gklg
𱋄	gqgn
𱋅	gqxn
𱋆	gqmh
𱋇	gqtn
𱋈	gqyt
𱋉	gqrh
𱋊	gqgs
𱋋	gqfc
𱋌	gqty
𱋍	gqyg
𱋎	gqpw
𱋏	gquk
𱋐	gqma
𱋑	gqtj
𱋒	gqth
𱋓	gqtk
𱋔	gqua
𱋕	gqoy
𱋖	gqgy
𱋗	gqeb
𱋘	gqit
𱋙	gqjs
𱋚	gqtl
𱋛	gqtb
𱋜	gqwy
𱋝	gquk
𱋟	gqde
𱋠	gqwj
𱋡	gqov
𱋢	gqug
𱋣	gqcs
𱋤	gqct
𱋦	gqwl
𱋧	gqua
𱋨	gqat
𱋩	gqtw
𱋪	gqyd
𱋫	gqaw
𱋬	gqoh
𱋭	gqgo
𱋮	gqae
𱋄	gtgn
𱋅	gtxn
𱋆	gtmh
𱋇	gttn
𱋈	gtyt
𱋉	gtrh
𱋊	gtgs
𱋋	gtfc
𱋌	gtty
𱋍	gtyg
𱋎	gtpw
𱋏	gtuk
𱋐	gtma
𱋑	gttj
𱋒	gtth
𱋓	gttk
𱋔	gtua
𱋕	gtoy
𱋖	gtgy
𱋗	gteb
𱋘	gtit
𱋙	gtjs
𱋚	gttl
𱋛	gttb
𱋜	gtwy
𱋝	gtuk
𱋟	gtde
𱋠	gtwj
𱋡	gtov
𱋢	gtug
𱋣	gtcs
𱋤	gtct
𱋦	gtwl
𱋧	gtua
𱋨	gtat
𱋩	gttw
𱋪	gtyd
𱋫	gtaw
𱋬	gtoh
𱋭	gtgo
𱋮	gtae
𱌠	golb
𱌿	gaud
𰀍	giat
𰀓	gjfm
𰀔	gjmf
𰀜	gigt
𰄟	gijh
𰅍	guwl
𰅖	gqjl
𰅙	gatl
𰈟	gdgk
𰈩	gdkm
𰋯	gduy
𰑼	gisn
𰢣	gnya
𰺬	gwmu
𰀎	hhhf
𰀏	hve
𰀗	hhhh
𰀠	hui
𰀤	hvgg
𰀥	hnnb
𰀦	hnnn
𰁄	hwnb
𰁐	hjln
𰄒	hnmg
𰄓	hghu
𰄗	hghn
𰅔	hanl
𰆃	hldu
𰆄	hjhd
𰆅	hlgk
𰆇	hmcc
𰆉	hmab
𰆸	hcu
𰇀	hpgc
𰉤	hcff
𰍧	htt
𰍨	hyy
𰍪	hiu
𰏧	hnrf
𰏭	haof
𰐇	haj
𰒬	hkwa
𰕐	hpgc
𰕗	hndt
𰕘	halc
𰕠	hjhr
𰕤	hjhr
𰖥	hvej
𰗧	hlns
𰘐	hxsy
𰘭	hhhs
𰙐	hhgw
𰙒	hoqw
𰙝	hgf
𰙞	htff
𰙡	hpxb
𰙢	hchf
𰙣	hnan
𰙥	hxrc
𰙫	hfuf
𰙭	hwyf
𰙯	hhdy
𰙰	hwye
𰙱	hpgf
𰙵	hymk
𰙹	hxii
𰛄	hnn
𰛅	htyi
𰛙	hiy
𰞿	hkao
𰟉	hvko
𰤞	hcnh
𰤟	hcfc
𰤠	hnnc
𰤢	hctg
𰤦	hcoy
𰤧	hcvv
𰤨	hcdp
𰤩	hctj
𰤫	hcfd
𰤱	hcme
𰤾	helf
𰥀	hhlf
𰥉	hlol
𰥋	hngg
𰥌	hghy
𰥍	hdu
𰥏	hkf
𰥒	hwwy
𰥓	hqrr
𰥔	htdy
𰥕	hgcy
𰥗	hrsh
𰥛	hykh
𰥝	hdoy
𰥢	hgmy
𰥣	hjcf
𰥤	hjvg
𰥧	huty
𰥨	hueg
𰥩	hnfy
𰥪	hfwq
𰥫	hbcy
𰥬	hawj
𰥭	hkjn
𰥮	hmdf
𰥯	hwcn
𰥱	hwyw
𰥴	hiug
𰥵	hafh
𰥷	hpak
𰥸	haws
𰥹	hipq
𰥻	hpuh
𰥽	hxjh
𰥿	hawn
𰦀	hudh
𰦁	hpoo
𰦃	htqs
𰦄	hipl
𰦅	hplp
𰦆	hoon
𰦇	hubg
𰦉	hfqq
𰦊	htwc
𰦋	htly
𰨔	hfim
𰩠	huf
𰮗	hkef
𰲘	haqx
𰲙	hawj
𰲛	hamk
𰲜	haqq
𰲞	haqa
𰲟	hamg
𰲡	haec
𰲢	hawk
𰲣	havk
𰲤	hadf
𰲦	haqj
𰲧	haxr
𰳐	hjju
𰴏	hqqk
𰴑	hqtk
𰴜	haeq
𰴞	hagq
𰴬	hqyg
𰶵	hmu
𰷮	haqm
𰻤	hbh
𱀠	hnnh
𱂎	hpgg
𱆉	hggm
𱈡	hhwo
𱈢	hnmo
𱊫	hakg
𱊶	hlof
𱊷	hlos
𱊸	hlon
𱊹	hloj
𱊺	hlqf
𱊻	hlqu
𱊼	hlqc
𱊽	hlqe
𱌚	hbdy
𱌛	hbty
𱌜	hbwv
𱌝	hbwb
𱌞	hbcc
𱌡	hbuh
𱌢	hbpe
𱌣	hbpn
𱌤	hbtp
𱌧	hbdg
𱌨	hbbo
𱌩	hwba
𱌪	hwby
𱌫	hwbw
𱌬	hwbf
𱌭	hwbv
𱌮	hwbk
𱌯	hwbk
𱌰	hwbq
𱌱	hwbt
𱌳	hwbl
𱌴	hwbo
𱌵	hwbg
𱌶	hwbc
𱌷	hwbf
𱌹	hwby
𱌺	hwbw
𱌻	hwbl
𱌼	hwba
𱌽	hwbl
𰄓	hgmu
𰄗	hgmn
𰆆	hmfm
𰆈	hmwd
𰏧	hnrh
𰥉	hlql
𰥦	htmc
𰥳	hyhk
𰲦	hamj
𰴑	hqgk
𱂽	hkmj
𱊶	hlqf
𱊷	hlqs
𱊸	hlqn
𱊹	hlqj
𱌡	hbuk
𰀶	ipnb
𰃮	ipb
𰃾	iyve
𰈌	iitx
𰊇	irgf
𰊖	iksf
𰊢	ilrf
𰊣	ioof
𰋷	ivf
𰍩	iwu
𰍫	iyeu
𰒒	igkn
𰕋	imkc
𰕒	ipkc
𰗞	ivsu
𰛇	ify
𰛈	ihg
𰛉	iun
𰛊	icg
𰛋	ifu
𰛌	iftt
𰛍	idcy
𰛎	ifwy
𰛏	iwwy
𰛐	iqwy
𰛑	ipgg
𰛒	iaiy
𰛓	igcy
𰛔	iduy
𰛗	iuxn
𰛘	ikry
𰛚	immg
𰛛	iuwy
𰛜	ihnn
𰛝	ivcy
𰛞	iglt
𰛟	iguf
𰛠	igqx
𰛡	ixxf
𰛢	idhf
𰛤	iabh
𰛥	imnn
𰛦	imqy
𰛧	ihiy
𰛨	iqmy
𰛩	iucg
𰛫	irth
𰛬	ifmd
𰛭	ixxf
𰛮	ihlq
𰛯	itmn
𰛰	iwda
𰛱	itfp
𰛲	iwgi
𰛳	iqwy
𰛴	iran
𰛵	iusy
𰛶	iybg
𰛷	iumi
𰛸	ippy
𰛹	iynn
𰛺	ibeg
𰛻	ivoy
𰛼	iceh
𰛽	isdm
𰛿	ihjc
𰜀	iheg
𰜁	ijxx
𰜃	immk
𰜄	itet
𰜆	ieef
𰜇	iwgr
𰜈	iilg
𰜋	inyi
𰜌	ilvt
𰜍	ifku
𰜎	isbl
𰜏	idmy
𰜐	ijtq
𰜑	iatc
𰜒	ikhl
𰜓	ihif
𰜔	ikhj
𰜕	ijlf
𰜖	imwl
𰜗	ikkk
𰜘	iths
𰜙	iebl
𰜚	iwyg
𰜛	iwyg
𰜜	iusy
𰜝	iudj
𰜞	ipqd
𰜟	iukh
𰜠	inve
𰜡	ibth
𰜢	ilkm
𰜣	inug
𰜤	imwg
𰜥	ifjj
𰜦	iafh
𰜧	ijfk
𰜨	iadb
𰜩	ildn
𰜪	ikhh
𰜫	irgp
𰜬	iqnm
𰜭	iwgk
𰜮	iybg
𰜰	iivg
𰜱	irrj
𰜲	iglf
𰜳	immv
𰜴	iath
𰜵	ikkl
𰜶	irnk
𰜷	itxt
𰜸	iwuh
𰜹	itmt
𰜺	itug
𰜻	iqtj
𰜼	ipbc
𰜽	iuql
𰜿	ipqo
𰝀	iulc
𰝁	iuft
𰝂	icci
𰝃	ifyt
𰝄	iceb
𰝅	iapk
𰝆	ijjy
𰝇	itwf
𰝈	ipww
𰝊	iuxh
𰝋	ibqn
𰝌	ixjb
𰝍	inpl
𰝎	ixgj
𰝏	iunf
𰝐	ivaf
𰝑	ifal
𰝒	iskb
𰝓	iger
𰝔	irwk
𰝕	ikll
𰝖	ijmn
𰝗	ituj
𰝘	ioom
𰝙	idhe
𰝚	isre
𰝛	ilrf
𰝜	idjd
𰝝	idnl
𰝞	itvj
𰝟	iqgd
𰝠	ipnc
𰝡	ipve
𰝢	isdp
𰝣	iswk
𰝤	ijom
𰝥	iitd
𰝦	irpk
𰝧	irxs
𰝨	iuen
𰝩	iyuo
𰝪	ivge
𰝫	inso
𰝬	ifee
𰝭	iaji
𰝮	iysd
𰝯	iyjn
𰝰	ifdf
𰝱	iycr
𰝲	isun
𰝳	ipud
𰝴	ipfn
𰝵	iqac
𰞹	ihco
𰟊	ipko
𰟮	iamo
𰢃	ipky
𰢫	ittg
𰣈	iptl
𰤹	iwlf
𰥟	ithn
𰮨	icbw
𰴣	ipqe
𱈤	icwo
𱉰	igwg
𱊉	ipbg
𱊞	igkg
𰃌	iqlv
𰃐	iqde
𰃑	iqim
𰃒	iqqn
𰃔	iqiq
𰃕	iqfn
𰏵	iqyt
𰛘	ikqy
𰜇	iwgq
𰜯	ipwl
𰝓	igeq
𰝕	ikjl
𰝱	iycq
𰀡	jcy
𰀢	jtyy
𰁉	jghn
𰁍	jfcn
𰅊	jglr
𰅊	jglb
𰆌	jbj
𰆐	jfbj
𰍯	jdny
𰑡	jcfn
𰑶	jtgn
𰕰	jfqn
𰕱	jgnn
𰕲	jjg
𰕳	jbg
𰕴	jan
𰕵	jdlt
𰕶	jmcy
𰕷	jwjh
𰕸	jghg
𰕹	jflt
𰕺	jgcy
𰕻	jlh
𰕼	jjhh
𰕿	jsf
𰖀	jnfg
𰖁	jgmi
𰖂	jivg
𰖄	jqgb
𰖅	jtfq
𰖇	jdqn
𰖈	jgod
𰖉	jgku
𰖊	jjdy
𰖋	jtww
𰖌	jqtg
𰖍	jgji
𰖎	jdey
𰖏	jlpy
𰖐	jgfg
𰖑	jrpy
𰖒	jgdj
𰖓	jpud
𰖔	jijg
𰖕	jblg
𰖖	jgmc
𰖙	jyde
𰖚	jovg
𰖛	jcy
𰖜	jfay
𰖝	jqyl
𰖞	jtgf
𰖟	jiye
𰖠	jcwy
𰖡	jgam
𰖢	jfyt
𰖣	jafy
𰖤	jiph
𰖦	jjpn
𰖧	jtdp
𰖩	jybc
𰖪	jyud
𰖬	jybt
𰖭	jugh
𰖮	jnnw
𰖯	jdap
𰖰	jghc
𰖱	jwgp
𰖳	jtgb
𰖵	jvhl
𰖶	jtel
𰖷	jujv
𰖸	jptl
𰖹	jftf
𰖺	jflw
𰖻	jugi
𰖼	jalj
𰖽	jtfm
𰖾	jdwj
𰖿	jtyg
𰗘	jtys
𰗩	jstc
𰗳	jsgg
𰘊	jsda
𰘋	jsrc
𰘪	jsyy
𰘬	jswn
𰙁	jsad
𰙏	joqw
𰙻	jfdh
𰚪	jtyn
𰟀	jhou
𰟈	jqko
𰢮	jftg
𰣐	jhjq
𰤮	jjhc
𰤼	jjlf
𰭤	jqrn
𰲐	jays
𰲩	jvn
𰲪	jtcy
𰲫	jfqn
𰲬	jlh
𰲭	jju
𰲮	jcju
𰲯	jwwy
𰲰	jwxn
𰲲	jyly
𰲳	jfay
𰲵	jcfh
𰲶	jcag
𰲷	jnhy
𰲹	jmnn
𰲺	jfpy
𰲻	jdpy
𰲼	jjfh
𰲽	japg
𰲾	jqeh
𰳁	jgmy
𰳂	jlrh
𰳃	jsoy
𰳅	jheg
𰳆	jhwb
𰳇	jipf
𰳈	jpeg
𰳉	jxqi
𰳊	jfam
𰳌	jmpy
𰳍	jody
𰳏	jipq
𰳓	jpyq
𰳔	jcex
𰳕	jvye
𰳗	jmmv
𰳘	jmdf
𰳙	jugl
𰳛	jriq
𰳜	jbdf
𰳞	jope
𰳟	jvqo
𰳠	jqvo
𰳡	jugi
𰳥	jann
𰳦	jptm
𰷙	jftm
𰹾	jtyl
𰻂	jopi
𰼘	jfnb
𰼙	jfqu
𰼝	jfuj
𱂙	jvdm
𱈯	jewo
𱉗	jgqg
𱉶	jfqg
𱊂	jeqg
𱊲	jawg
𰕵	jdln
𰕹	jfln
𰖭	judh
𰲿	jgip
𰳟	jvwo
𰖢	jgqt
𰖪	jumd
𰁅	kfin
𰇇	kfg
𰇊	kfny
𰇎	kaiy
𰇏	khg
𰇐	klg
𰇒	kwtn
𰇓	kgmh
𰇕	kgud
𰇗	krkg
𰇘	kmjh
𰇚	kqwh
𰇛	kwdy
𰇜	krnq
𰇞	kyjj
𰇡	kxtn
𰇢	kcsy
𰇣	kcay
𰇦	kfgn
𰇧	kfnw
𰇨	kwkx
𰇪	kkkh
𰇫	kkcb
𰇬	kqyy
𰇰	knfy
𰇱	kgnk
𰇲	kwym
𰇳	kqky
𰇵	krnr
𰇶	kduf
𰇷	kyty
𰇸	kynh
𰇹	kifc
𰇻	kbdi
𰇼	kcde
𰇽	kntj
𰈁	krqi
𰈂	kgct
𰈃	krxj
𰈄	krwk
𰈆	kjtq
𰈇	kipc
𰈈	khah
𰈉	kuxe
𰈊	khko
𰈋	kqtj
𰈍	kusy
𰈎	kphi
𰈏	kbcl
𰈐	kvyb
𰈒	kdmn
𰈓	kjtl
𰈔	klge
𰈘	ktws
𰈙	ktem
𰈚	kprw
𰈝	kbmy
𰈞	knhh
𰈡	kumt
𰈢	ktjg
𰈣	kwhe
𰈤	ktug
𰈥	keuq
𰈦	kwgl
𰈨	ktdp
𰈪	kakn
𰈬	kkkt
𰈭	kwyo
𰈮	kxaf
𰈯	kfmd
𰈰	kjec
𰈱	ktfw
𰈲	kqrw
𰈶	kxgf
𰈸	kbci
𰈹	kgku
𰈻	kkjn
𰈼	kwym
𰈾	kdno
𰈿	khqf
𰉀	kwsm
𰉁	kutm
𰉂	kyut
𰉃	kiaf
𰉄	ktfm
𰉅	kqmm
𰉆	krps
𰉉	kqod
𰉊	krmj
𰉋	kynd
𰉌	kueh
𰊩	kahf
𰊪	kkaf
𰊽	kgnf
𰌑	kgev
𰍵	kwny
𰏃	kgjg
𰏬	kkkf
𰓲	kejr
𰕣	kkjr
𰕥	kkjr
𰗪	kasu
𰙧	kkhf
𰠧	krhj
𰡧	kkjd
𰢸	klf
𰣜	kklp
𰤻	kkhl
𰮄	kmww
𰲨	kkkw
𰷒	khgw
𰷓	khgg
𰸁	khvt
𰸂	khdy
𰸃	khqy
𰸄	khnr
𰸅	khhc
𰸆	khuy
𰸇	khcc
𰸉	khdf
𰸊	khmq
𰸋	khrk
𰸌	khej
𰸎	khut
𰸐	khgy
𰸑	khdq
𰸒	khqj
𰸓	khcc
𰸔	khlp
𰸕	khhe
𰸖	khjb
𰸗	khmo
𰸘	khnf
𰸙	khce
𰸚	khgh
𰸜	khas
𰸝	khan
𰸞	khkm
𰸟	khil
𰸠	khmj
𰸡	khwa
𰸢	khti
𰸣	khqn
𰸤	khqu
𰸥	khys
𰸧	khbg
𰸨	khao
𰸩	khqp
𰸪	khtf
𰸫	khfe
𰸬	khrh
𰸭	khmk
𰸮	khjf
𰸯	khxg
𰸰	khhm
𰸱	khwu
𰸲	khtb
𰸳	khac
𰸴	khxh
𰸵	khwm
𰸶	khww
𰸸	khwh
𰸹	khab
𱈠	knho
𱈽	kkuo
𱊡	kwyg
𱌂	kjnu
𰃡	kljw
𰇖	kfcl
𰇥	kdnp
𰈁	kriq
𰈘	ktwt
𰉂	kumt
𰓲	kljr
𰸢	khgi
𰸦	khlm
𰸩	khip
𰅚	lkyn
𰇠	lkwx
𰅎	ltfh
𰀨	lxih
𰄻	lpjh
𰈅	ljfx
𰉍	lwyn
𰉎	lnhd
𰉏	lhkd
𰉐	ldf
𰉑	lduf
𰉓	lkdf
𰉔	ladm
𰌆	lrvf
𰐋	lkga
𰐍	layy
𰑧	lrnu
𰙌	lnqw
𰚆	lvwc
𰚺	lqqa
𰞰	lkdo
𰟌	lxou
𰠃	ldry
𰢵	lbk
𰢶	lgnn
𰢹	lgah
𰢺	lwxn
𰢼	leu
𰢽	lqrr
𰢿	ldkg
𰣀	ltgf
𰣁	ldkf
𰣂	lmfg
𰣆	ltkg
𰣉	llgg
𰣍	lukh
𰣎	lawi
𰣏	ldwi
𰣖	llpg
𰣙	lwxc
𰣚	lxak
𰣞	llfl
𰣟	llkl
𰤲	lsj
𰤷	llf
𰤺	lqlf
𰫥	lxnn
𰭈	lhcu
𰭋	lfmg
𰭌	ludj
𰭎	luj
𰭑	lifc
𰭔	lxke
𰴿	lwwy
𰹈	lnn
𰹉	lnv
𰹊	ltan
𰹋	lqyy
𰹍	lsgg
𰹎	ltmw
𰹏	lqbh
𰹐	llkg
𰹑	lyjg
𰹒	lniy
𰹓	lakg
𰹔	ljsy
𰹕	lkck
𰹖	ltgi
𰹗	legf
𰹘	lepc
𰹙	lqfh
𰹚	lccw
𰹛	ltay
𰹛	ltgi
𰹝	lukh
𰹟	lkhl
𰹠	lwyb
𰹡	lxgj
𰹣	lqhn
𰹤	lgjl
𰹥	ljlq
𰹦	lqym
𰹧	lvfj
𰹨	lmdp
𰹩	lpgm
𰹪	lyuo
𰹬	lady
𰹭	ltft
𰹮	lauo
𰹯	lnn
𰹰	ltyy
𰹱	lbn
𰹲	lkf
𰹳	lkh
𰹴	lmyy
𰹵	lyqy
𰹶	lgg
𰹷	lfqn
𰹸	lgbn
𰹹	lavt
𰹺	lrcy
𰹻	lcn
𰹼	lgay
𰹽	lguf
𰹿	lwfy
𰺀	lqay
𰺁	lqkg
𰺂	lqnn
𰺃	lcfy
𰺄	lawy
𰺆	lqjg
𰺇	lpfq
𰺈	lvtk
𰺉	lgeg
𰺊	lfwt
𰺋	lbcy
𰺌	lfnd
𰺍	ljsy
𰺎	lhdd
𰺏	leeg
𰺐	lqvg
𰺑	lpqb
𰺒	lmdj
𰺓	ltjt
𰺔	lqbt
𰺕	lyac
𰺖	ldwt
𰺗	ljtl
𰺙	lfuk
𰺚	ldmj
𰺛	ldui
𰺜	ltol
𰺝	lujf
𰺞	lnbb
𰺟	lbml
𰺠	lfmd
𰺡	lafl
𰺢	lddd
𰺣	lauy
𰺤	lthy
𰺹	lftp
𰻐	lafp
𰻵	ljnb
𰻾	lhdb
𰼻	lcaq
𱂲	lndm
𱈶	lwvo
𱊬	lqjg
𱊳	lllg
𱋶	lfon
𱋷	lfox
𱋸	lfoh
𱋹	lfoj
𱋺	lfof
𰅌	lnan
𰅏	lkhn
𰅗	ltqh
𰟌	lxgo
𰣊	lldc
𰣌	llud
𰣑	lcbi
𰣔	lgel
𰣛	lluj
𰫥	lxin
𰹜	lqbc
𰹝	lusk
𰹠	lwye
𰹢	lcbi
𰹥	ljln
𰻾	ldjb
𱈶	lwvt
𰀊	mhgn
𰁊	mjnb
𰃧	mtfd
𰃨	muci
𰃩	majd
𰃪	mvgh
𰃭	mnww
𰄹	mjvt
𰆹	mcy
𰇋	mykf
𰇑	mmgk
𰇙	mykx
𰇩	mkf
𰊲	mytf
𰋙	mdi
𰌮	mbti
𰎉	mxb
𰎋	mef
𰎌	mwwy
𰎍	mcqn
𰎎	mdxy
𰎏	maiy
𰎐	mhnt
𰎑	mogf
𰎒	mrf
𰎓	mxlr
𰎔	matq
𰎖	mmjj
𰎗	mejj
𰎘	mkqy
𰎙	mwey
𰎛	mwfc
𰎜	muqu
𰎝	mplh
𰎞	mpey
𰎟	mdww
𰎠	mgod
𰎡	mgdu
𰎢	mlfh
𰎤	mnpm
𰎥	mfqf
𰎦	maqw
𰎩	mdjb
𰎪	mfch
𰎫	mqtd
𰎭	mypq
𰎮	msnu
𰎯	mwyb
𰎰	mnie
𰎱	mmee
𰎲	mnhf
𰎳	mipf
𰎴	mngt
𰎵	mkkt
𰎶	mkkt
𰎷	mtkm
𰎸	mudk
𰎹	mfmd
𰎺	mdgn
𰎻	mgdy
𰎼	makw
𰎽	mmnn
𰎾	mtmt
𰎿	mmka
𰏀	mhqe
𰏁	mtfm
𰏂	mmkt
𰏒	mhmh
𰏓	mhqg
𰏔	mhym
𰏕	mhfy
𰏖	mhtp
𰏗	mhmh
𰏜	mhov
𰏟	mhui
𰏠	mhsh
𰗁	mafh
𰗆	mqeg
𰚹	mdna
𰞂	mnou
𰞄	mdou
𰞅	mou
𰞎	mwwo
𰢤	mmgy
𰢻	mqrr
𰤤	mwwc
𰥘	mdhf
𰥙	mfhf
𰭊	mwsj
𰭍	mwqq
𰭏	mwag
𰭓	mqxa
𰭕	mwxg
𰭖	mqqx
𰭖	mqqi
𰭭	mdmf
𰭮	mdmg
𰭾	mwwn
𰮂	mwwl
𰮆	mwwn
𰮈	mwwh
𰮉	mwwh
𰮏	mwwc
𰮖	mwwh
𰮘	mwwg
𰮛	mwwg
𰮜	mwwk
𰮞	mwwh
𰮣	mwwc
𰮧	mwwk
𰮪	mwwb
𰮮	mwwe
𰮻	mwww
𰯆	mwwh
𰯣	mwwm
𰯦	mwwq
𰰔	mgve
𰲥	mahw
𰴎	mdhq
𰶣	magc
𰶴	mfyy
𰶷	mqwy
𰶹	myy
𰶻	mxhh
𰶼	mlg
𰶽	mkry
𰶾	mwyc
𰶿	mpxn
𰷀	mbg
𰷁	mivg
𰷂	mqqy
𰷃	mnmu
𰷅	mdhn
𰷇	mrgm
𰷈	mqoy
𰷉	mdmd
𰷊	mfay
𰷋	mawa
𰷏	mgcc
𰷑	mfke
𰷖	muvo
𰷗	mbmc
𰷘	mfoo
𰷚	mpnm
𰷛	myuo
𰷜	mqdy
𰷟	mnrt
𰷠	mbn
𰷡	mfqn
𰷢	mqay
𰷤	mywf
𰷨	mrqc
𰷩	mudm
𰷪	muwl
𰷫	mddd
𰷬	myuo
𰷭	mdny
𰷯	mgko
𰺱	mhpk
𰻁	mawp
𰻏	mwgp
𰻩	mmkc
𰻶	mhmb
𱁇	mgwy
𱂤	mqdm
𱂵	medm
𱃠	mqdd
𱅭	medj
𱅮	meaq
𱅯	medh
𱅰	medn
𱅱	madw
𱅲	mehe
𱅳	megn
𱆜	muyc
𱈦	mado
𱉃	mlwo
𱉐	mqyg
𱌀	mdkn
𱍄	mfqn
𰀷	mmnn
𰄐	mwga
𰄒	mmgg
𰎓	mxlb
𰐻	mnu
𰐽	mynu
𰗁	mafg
𰭒	mqpe
𰮮	mwwl
𰲥	mahm
𰶽	mkqy
𱂾	mtjb
𱃁	mtjt
𱃂	mtjy
𱃄	mtjm
𱃅	mtje
𱃈	mtjc
𱃊	mtjl
𱃋	mtjt
𱃍	mtji
𱃎	mtjc
𱃐	mtjo
𱃑	mtjc
𱃒	mtjb
𱃓	mtjj
𱅱	meaw
𱈢	mmgo
𱈦	mawo
𰎯	mwye
𰣇	myvl
𱂾	mgjb
𱃀	mgjo
𱃀	mtjo
𱃁	mgjt
𱃂	mgjy
𱃄	mgjm
𱃅	mgje
𱃈	mgjc
𱃊	mgjl
𱃋	mgjt
𱃍	mgji
𱃎	mgjc
𱃐	mgjo
𱃑	mgjc
𱃒	mgjb
𱃓	mgjj
𱃔	mqee
𱃕	mqat
𱃖	mqxl
𱃗	mqck
𱃘	mqgj
𱃙	mqyj
𱃚	mqll
𱃛	mqei
𱃜	mqtv
𱃝	mqmq
𱃞	mqwj
𱆖	mrqc
𰀣	nhfw
𰀧	nhmk
𰀰	nnnb
𰀳	ndny
𰀼	nckd
𰁀	nuak
𰁈	nnhr
𰁋	nkkk
𰁌	nuud
𰁏	nuuk
𰄚	ngjh
𰄜	njh
𰄝	nrjh
𰅂	nftj
𰅯	nnnf
𰆔	nkay
𰇯	ngbk
𰇾	ngkk
𰈠	ndhx
𰌱	nbnb
𰍣	nkua
𰍰	ngd
𰍱	nfny
𰍲	nui
𰍳	nnoi
𰍴	ninn
𰍶	ntgs
𰍷	nyqb
𰍸	nrfc
𰍹	nlk
𰍺	ntfd
𰍻	nifd
𰍼	nxdf
𰍽	nrgw
𰍾	ntmk
𰍿	ntfb
𰎀	nyph
𰎁	notn
𰎂	ninn
𰎃	ngcq
𰎄	ntfw
𰎅	ntfj
𰎆	ntmt
𰏱	nhxg
𰐺	nnu
𰐾	nyt
𰐿	nnrt
𰑁	nfny
𰑂	nmry
𰑃	njg
𰑄	nwxn
𰑅	nwwy
𰑇	ntgf
𰑊	nfcy
𰑌	nmdy
𰑍	nklt
𰑏	npxn
𰑐	nudg
𰑒	ntnu
𰑖	nrhf
𰑗	ntkr
𰑘	nudh
𰑙	nyjh
𰑚	npfy
𰑛	nyta
𰑝	nfmd
𰑞	nfny
𰑠	nksy
𰑤	npdc
𰑥	nueg
𰑦	nyig
𰑪	nkjn
𰑫	nlqy
𰑬	nrfm
𰑮	nyty
𰑯	ncwn
𰑰	nfpl
𰑱	ndjb
𰑳	nfmf
𰑹	nuej
𰑺	nitd
𰑽	nimy
𰑿	nipq
𰒀	ncy
𰒂	nbtn
𰒅	nfvg
𰒆	nagw
𰒇	nwde
𰒈	nybb
𰒉	npbc
𰒋	ndgr
𰒎	nwys
𰒏	nqqw
𰒐	nugh
𰒑	nuvo
𰒓	nnhk
𰒔	ngml
𰒕	nlga
𰒗	ndqq
𰒙	niay
𰒞	nvln
𰒟	nsue
𰒡	nfkk
𰒢	ntly
𰕟	nymr
𰕾	nmjf
𰖴	nlrj
𰘤	nfis
𰚭	nnwn
𰚷	ngnf
𰞫	ntfo
𰠎	nhdc
𰠏	nhdc
𰠐	nhdr
𰠑	nhdg
𰠒	nhdk
𰠓	nhdh
𰠔	nhdf
𰠕	nhdd
𰠖	nhdk
𰠘	nhdp
𰠨	nrhk
𰢲	ntej
𰤴	ntlf
𰦱	nadf
𰧠	nfid
𰨚	ntky
𰪰	noi
𰭝	ngf
𰭞	nfjj
𰭠	nnyy
𰭡	nnty
𰭢	ngud
𰭥	naky
𰳢	nhjj
𰴕	ntmq
𰴧	nyd
𰺲	nrpe
𰻠	nbh
𰻰	nfcb
𱁌	nwiy
𱁿	nhky
𱂀	nhki
𱂁	nhkc
𱂂	nhkj
𱃟	nrmq
𱈟	nywo
𱈹	nwio
𱉔	nwqg
𱉳	nudg
𱉽	nnqg
𱊌	ndqg
𱊩	nftg
𱊱	nwyg
𱌉	nkun
𰀥	nhnb
𰀦	nhnn
𰁈	nnhq
𰆔	nhky
𰍶	ntfh
𰍷	nybk
𰑍	nkln
𰑐	nufg
𰑗	ntkq
𰑾	nall
𰒋	ndgq
𰒐	nudh
𰒓	nnhq
𰪰	nhoi
𰄽	onrv
𰋖	ovqq
𰋧	oodu
𰌕	ovan
𰐫	ovet
𰒄	oufn
𰘑	oufs
𰙕	ovqw
𰚊	oguc
𰚦	ovtn
𰜉	ooiu
𰝶	obh
𰝷	oaf
𰝹	oqyu
𰝺	oqyy
𰝼	obg
𰝾	otay
𰝿	otfh
𰞃	ouxn
𰞇	ocfh
𰞉	ofcl
𰞋	ogud
𰞌	orta
𰞍	oabh
𰞏	olft
𰞑	oqcn
𰞒	oqdb
𰞔	oqkg
𰞗	ovsy
𰞛	oofh
𰞝	ovvg
𰞢	ofqu
𰞣	omwn
𰞤	ojcf
𰞥	oloy
𰞦	otet
𰞩	owgs
𰞪	oodn
𰞬	ovlg
𰞭	ohly
𰞮	ojgd
𰞱	ohaq
𰞳	oqgg
𰞵	oorc
𰞷	ocde
𰞸	ovkb
𰞺	oght
𰞻	ofam
𰞾	oadk
𰟁	owyg
𰟂	oqno
𰟃	opde
𰟄	outk
𰟋	oldc
𰟍	owrq
𰟎	ooaw
𰟏	ouwl
𰟐	oakg
𰟒	osgy
𰟓	oamy
𰟔	otfp
𰟕	otwh
𰟖	oxtw
𰟘	ouqv
𰟙	oads
𰟜	osff
𰟟	ougg
𰟡	oijr
𰟢	oipq
𰟤	oduo
𰟦	ojmn
𰟧	okba
𰟨	ovnn
𰟪	obci
𰟫	outk
𰟬	ohio
𰟭	oooo
𰟯	oopl
𰟰	oddj
𰟲	opaq
𰟵	olfd
𰟸	obww
𰟺	ooos
𰟻	okkt
𰡪	ossk
𰢦	ovgy
𰣘	oolf
𰥼	othf
𰪧	oah
𰪩	oyt
𰪪	ocg
𰪫	ofny
𰪬	ogg
𰪭	otay
𰪮	otah
𰪯	otfg
𰪱	ogcy
𰪲	oskg
𰪳	ogoy
𰪴	olh
𰪵	orwy
𰪶	olft
𰪷	oidy
𰪸	ovjg
𰪹	orhf
𰪺	otgs
𰪼	outt
𰪽	otjh
𰪾	odwg
𰪿	oapl
𰫀	ojgf
𰫁	oufg
𰫂	ouxe
𰫃	oplh
𰫄	ovfg
𰫅	oitk
𰫆	ocy
𰫇	oawk
𰫈	otgf
𰫉	oprw
𰫊	ouqi
𰫋	oagw
𰫌	owvq
𰫎	oypy
𰫏	outg
𰫐	odwv
𰫑	oybt
𰫒	opjh
𰫓	oulj
𰫔	osgt
𰫕	oyvj
𰫖	oaui
𰴔	owyq
𰴚	ovmq
𰻋	orpk
𱂖	osdm
𱂧	odmy
𱈲	ovwo
𰞋	oguw
𰞩	otwt
𰞱	oham
𰟍	owqq
𰪦	oqy
𰪺	otfh
𰪻	oqsy
𰫍	otgl
𰴔	ogwq
𰪾	odwh
𰃓	pegq
𰃫	pdhm
𰃯	pguf
𰃰	pmf
𰃱	pvlf
𰃲	piss
𰃳	pujm
𰃴	pujm
𰅄	pwfj
𰇝	pkcu
𰇭	pvyk
𰈜	puvk
𰈵	pgkx
𰋘	pntq
𰌰	phnb
𰌳	pbb
𰌴	pdf
𰌵	pcyu
𰌷	pyly
𰌸	pvtr
𰌹	pfaj
𰌺	pkbj
𰌻	pdhf
𰌼	pdjf
𰌽	pvkf
𰌾	pdnh
𰌿	pgva
𰍀	pwyg
𰍁	pfqg
𰍂	psmc
𰍃	ptlb
𰍄	pwnf
𰍅	pnbm
𰍆	pgwf
𰍇	pafs
𰍈	pfic
𰍉	pawb
𰍊	padk
𰍋	pqrn
𰍌	piaw
𰍍	pnwk
𰍏	pdri
𰍐	pawe
𰍑	pfqs
𰍒	pdjs
𰍓	pliu
𰍔	pugo
𰍕	ppuc
𰍖	pnyf
𰍗	pnsu
𰍘	pifj
𰍙	ppuc
𰍚	pvlq
𰍜	pwys
𰍝	pakb
𰍞	ptkt
𰍟	ptek
𰍠	pvig
𰍡	pnlu
𰍢	pwwk
𰒣	pkkn
𰗷	pwks
𰙶	pawh
𰚔	pstn
𰚠	pfin
𰞀	pou
𰞶	pego
𰠇	puvc
𰤪	pfqc
𰥡	pfhf
𰧮	pygj
𰧯	pygc
𰧰	pynr
𰧱	pymf
𰧳	pygj
𰧴	pyay
𰧵	pyuf
𰧶	pyay
𰧷	pygw
𰧹	pyvk
𰧺	pyqq
𰧻	pywc
𰧼	pytk
𰧽	pytk
𰧾	pype
𰨀	pyga
𰨁	pyff
𰨂	pyts
𰨃	pywf
𰨄	pylv
𰨅	pydd
𰨆	pyxm
𰨈	pyyf
𰨉	pypn
𰨊	pytp
𰨋	pyef
𰨌	pyuh
𰨍	pyvp
𰨎	pyrl
𰨏	pyql
𰨐	pygh
𰨑	pygm
𰨒	pypw
𰨓	pynw
𰨕	pyjk
𰨖	pyjm
𰨗	pyfo
𰨙	pyaa
𰩄	pwcc
𰩅	pwdy
𰩆	pwak
𰩇	pwqb
𰩈	pwti
𰩉	pqxl
𰩊	pqhi
𰩋	pqff
𰩍	pwan
𰩎	pqkc
𰩏	pwts
𰩐	pqdg
𰩑	pwhw
𰩒	pwhc
𰩓	pwgq
𰩔	pwff
𰩖	pwjv
𰩗	pqaj
𰩘	pwng
𰩙	pwad
𰩚	pwav
𰩛	pwvo
𰩜	pqdo
𰩝	pqrc
𰩞	pwvt
𰩟	pwaf
𰭉	pwkq
𰭐	pwhw
𰳰	puxn
𰳱	puuy
𰳲	pudy
𰳴	puwy
𰳵	puan
𰳶	pulk
𰳷	pucf
𰳸	pudd
𰳹	puyi
𰳺	pupe
𰳻	pudp
𰳼	pugy
𰳽	pufb
𰳾	puel
𰳿	puev
𰴀	purw
𰴁	puad
𰴂	puce
𰴃	puyl
𰴄	puui
𰴅	puhl
𰴇	puif
𰴈	putt
𰴉	pupn
𰴊	puha
𰴴	pvyf
𰶖	pakk
𰶸	pmu
𰷕	pwam
𰷥	pfim
𰻝	pwyp
𰻝	pwep
𰻞	pwep
𰻞	pwyp
𰻬	pfqb
𰻺	pntb
𰻻	poob
𰿍	pede
𱁏	pnmy
𱂨	pvdm
𱂸	prwm
𱃉	pocj
𱆡	pnmc
𱈳	pwto
𱉂	palo
𱉱	plqg
𱊊	pwag
𱊖	pwdg
𱊟	pdhg
𱌆	pjun
𰌶	pgiu
𰍁	pfqh
𰍐	pfje
𰙶	pfjh
𰚅	plmc
𰨌	pyuk
𰩈	pwqi
𰩗	pwaj
𰳴	puwa
𰳸	pucf
𰁎	qann
𰃊	qhd
𰄖	qtjg
𰄲	qvit
𰅈	qkqj
𰅛	qwi
𰅜	qrln
𰅝	qcqy
𰅟	qnaw
𰅠	qtjn
𰉈	qojd
𰋏	qgkt
𰋐	qqvn
𰋑	qqaw
𰋒	qqih
𰋓	qqkh
𰋔	qqff
𰋕	qqpi
𰋫	qtjd
𰑭	qatn
𰑷	qkqn
𰓅	qarj
𰔥	qtjs
𰕙	qxty
𰖘	qadj
𰗕	qsu
𰘞	qsyg
𰘼	qtjs
𰙋	qngw
𰚋	qkxn
𰞕	qtvo
𰞖	qtvo
𰞨	qklo
𰠾	qttf
𰠿	qtwv
𰡀	qudy
𰡁	qtuy
𰡂	qtgc
𰡃	qtfi
𰡄	qthn
𰡅	qtdc
𰡆	qteh
𰡇	qtqh
𰡉	qtgg
𰡊	qttj
𰡋	qtpl
𰡌	qtte
𰡍	qtdd
𰡎	qtgo
𰡏	qtkw
𰡐	qtkm
𰡑	qtyl
𰡒	qtuh
𰡓	qtgg
𰡔	qtlr
𰡕	qtsr
𰡖	qtkl
𰡗	qthw
𰡘	qtwm
𰡙	qtqj
𰡚	qtrw
𰡛	qtwa
𰡜	qtge
𰡝	qtah
𰡞	qtfm
𰡟	qtmj
𰡠	qtyc
𰡡	qtlk
𰡢	qtmv
𰡣	qtyt
𰡤	qtyo
𰡥	qtnr
𰡨	qtle
𰡩	qtar
𰡫	qtuo
𰡬	qtoj
𰢰	qreh
𰣃	qxlf
𰤡	qnhc
𰤸	qxlf
𰪨	qonv
𰮌	qcef
𰮢	qqbw
𰯭	qkqe
𰰖	qcud
𰰗	qcps
𰰚	qcyn
𰰛	qclo
𰴠	qecy
𰴡	qeaj
𰴢	qeqi
𰴤	qego
𰴥	qeuj
𰴦	qeuj
𰶒	qnwk
𰶯	qkes
𰶯	qjes
𰶶	qrmu
𰷐	qjmy
𰻟	qybh
𰻫	qlbh
𰻮	qynb
𰻹	qjbh
𰼟	qkf
𰼠	qnuy
𰼣	qpgg
𰼤	qgsy
𰼥	qhnt
𰼦	qnty
𰼧	qgjg
𰼨	qidy
𰼩	qayq
𰼬	qbig
𰼭	qfpy
𰼮	qlsy
𰼯	qtgh
𰼰	qqeh
𰼱	qrfh
𰼲	qqlg
𰼳	qwgg
𰼴	qngb
𰼸	qjyy
𰼹	qltu
𰼺	qlah
𰼼	qgbs
𰼾	qmeg
𰼿	qrgf
𰽀	qwyj
𰽁	qdty
𰽂	qtap
𰽃	qiwe
𰽄	qiti
𰽅	qybc
𰽆	qfhn
𰽇	qrjh
𰽉	qaju
𰽊	qgqe
𰽋	qpjh
𰽌	qyiy
𰽍	qjmp
𰽎	qccc
𰽏	qaiy
𰽐	qipj
𰽒	qqmt
𰽓	qwfq
𰽔	qujq
𰽕	qmn
𰽖	qln
𰽖	qlt
𰽗	qgfh
𰽘	qdy
𰽙	qhg
𰽚	qyt
𰽛	qiy
𰽜	qaqy
𰽝	qdln
𰽝	qdlt
𰽞	qdbn
𰽟	qfjh
𰽠	qhg
𰽡	qjg
𰽢	qmqn
𰽣	qxhh
𰽤	qnwy
𰽥	qgmw
𰽦	qdxy
𰽧	qgig
𰽨	qkwy
𰽩	qhhy
𰽪	qwag
𰽫	qtgg
𰽬	qty
𰽭	qqkg
𰽮	qwfy
𰽯	qygg
𰽰	qugh
𰽱	qxjh
𰽲	qfkg
𰽳	qdmy
𰽴	qdfn
𰽵	qiqn
𰽶	qjy
𰽷	qmqy
𰽸	qrey
𰽹	qqqy
𰽺	qqdb
𰽻	qwtf
𰽼	quah
𰽽	qudh
𰽾	qfpy
𰽿	qbnn
𰾀	qfpb
𰾁	qaiy
𰾂	qfmd
𰾃	qkhy
𰾄	qtxy
𰾅	qwyk
𰾆	qwwk
𰾇	qgdk
𰾈	qiit
𰾉	qpwf
𰾊	qtlq
𰾋	qylh
𰾌	qlrh
𰾍	qgey
𰾎	qrtf
𰾏	qqrm
𰾐	qhdd
𰾑	qqg
𰾒	qphn
𰾓	qijg
𰾔	qdnf
𰾕	qans
𰾖	qdae
𰾗	qdgy
𰾘	qadn
𰾙	qjmy
𰾚	qlge
𰾛	qlwj
𰾜	qmdj
𰾝	qjtg
𰾞	qqbt
𰾟	qtjt
𰾠	qqku
𰾡	qqyg
𰾢	qytb
𰾣	qngf
𰾤	qnhc
𰾥	qwgd
𰾦	qxge
𰾧	qgqt
𰾨	qamf
𰾩	qfcl
𰾪	qgon
𰾫	qjtl
𰾬	qjng
𰾭	qepc
𰾮	quvo
𰾯	qyvk
𰾰	qmwy
𰾱	qtln
𰾲	qynx
𰾳	qnbt
𰾴	qadr
𰾵	qduh
𰾶	qgjn
𰾷	qaqj
𰾸	qhnn
𰾹	qwym
𰾺	qtln
𰾻	qusd
𰾼	qnnw
𰾽	qnty
𰾾	qfmd
𰾿	qajn
𰿀	qjtq
𰿁	qynx
𰿂	qfdj
𰿃	qaly
𰿄	qlll
𰿅	qmwm
𰿆	qtfm
𰿇	qthj
𰿈	qwwg
𰿉	qllf
𰿊	qyny
𱂬	qadm
𱃌	qlkj
𱃏	qdwj
𱃱	qntn
𱃲	qnaq
𱃳	qngi
𱃴	qnyh
𱃵	qnmd
𱃶	qnlw
𱃷	qnug
𱃸	qngf
𱃹	qnmn
𱃺	qntd
𱃻	qnxy
𱃼	qnda
𱃽	qnww
𱃾	qnuk
𱃿	qnoo
𱄀	qnfm
𱄁	qnwj
𱄂	qnpc
𱄃	qnvp
𱄄	qnxe
𱄅	qnwe
𱄆	qnfk
𱄇	qnqe
𱄈	qnae
𱄉	qnen
𱄊	qntm
𱆘	qrrc
𱆥	qomy
𱆧	qgnf
𱆩	qokn
𱆪	qbqo
𱆬	qoxf
𱆭	qoaa
𱆮	qoaf
𱆯	qotb
𱆰	qoqn
𱆱	qoof
𱆲	qovo
𱆳	qosc
𱆴	qoss
𱆵	qoda
𱆶	qojv
𱆷	qowc
𱆸	qoyy
𱆹	qoov
𱆺	qouo
𱆻	qopn
𱆼	qobo
𱆽	qoma
𱆾	qolo
𱆿	qoda
𱇀	qodi
𱇁	qojf
𱇂	qgue
𱇃	qodg
𱇄	qoll
𱇅	qolf
𱇆	qotl
𱇇	qoyr
𱇈	qoud
𱇉	qofk
𱇊	qogj
𱇋	qoyx
𱇌	qoao
𱇍	qgnn
𱇎	qghy
𱇏	qgta
𱇐	qgfq
𱇑	qggh
𱇒	qgxx
𱇓	qggg
𱇔	qgmw
𱇕	qgty
𱇖	qgrc
𱇗	qgwx
𱇘	qgyw
𱇙	qgpq
𱇚	qggs
𱇛	qgfi
𱇜	qgfc
𱇝	qgdg
𱇞	qgjg
𱇟	qglh
𱇠	qglw
𱇡	qgtg
𱇢	qgyx
𱇣	qgny
𱇤	qgxl
𱇥	qggg
𱇦	qgdn
𱇧	qggw
𱇨	qghi
𱇩	qgtj
𱇪	qgtk
𱇬	qgah
𱇭	qggo
𱇮	qgan
𱇯	qgie
𱇰	qgkc
𱇲	qgeb
𱇳	qgct
𱇴	qgxw
𱇵	qggm
𱇶	qgff
𱇷	qgaj
𱇸	qgkn
𱇺	qgtb
𱇻	qgqv
𱇼	qgtk
𱇽	qgqo
𱇾	qgpi
𱇿	qgvj
𱈀	qgnd
𱈁	qgtp
𱈂	qgjy
𱈃	qgle
𱈄	qgwd
𱈅	qgqt
𱈆	qgov
𱈇	qgng
𱈈	qgng
𱈉	qghy
𱈊	qgql
𱈋	qgyk
𱈌	qguf
𱈍	qgxu
𱈎	qgcs
𱈏	qggp
𱈐	qggf
𱈒	qgar
𱈓	qgsj
𱈔	qgaj
𱈕	qgtl
𱈖	qggm
𱈗	qgfj
𱈘	qgij
𱈙	qgay
𱈚	qggk
𱈛	qgah
𱈜	qgqg
𱉄	qyvo
𱉇	qynn
𱉋	qynf
𱉌	qynq
𱉕	qynk
𱉙	qynw
𱉣	qynd
𱉭	qdbg
𱉸	qyns
𱉿	qynt
𱊄	qynq
𱊅	qyny
𱊆	qkqg
𱊇	qoqg
𱊜	qyng
𱊨	qyns
𱋼	qlxf
𱋽	qxql
𱌁	qkkn
𱍅	qjnc
𱍆	qjno
𰄪	qsvt
𰄵	qsjv
𰄼	qsjg
𰅒	qtvl
𰘞	qssg
𰡫	qtuc
𰼢	qwqy
𰼴	qvfb
𱂿	qnmj
𱆤	qodn
𱆧	qonf
𱆨	qocm
𱆶	qomv
𱇊	qoej
𰅱	qbfj
𰮍	qqmw
𰮎	qbmw
𰿳	qsuw
𱉹	qdmg
𰀪	rtt
𰁃	rgwn
𰁮	rwy
𰃎	rhjq
𰃙	rgky
𰈕	rnrx
𰊭	rjcp
𰋣	rwrw
𰌅	rcvf
𰎚	rgkm
𰎣	rnam
𰎬	rdfm
𰏝	rmhh
𰏫	rhfk
𰑔	rvyn
𰒷	ran
𰒸	rbh
𰒹	rnnn
𰒺	rngg
𰒻	rbh
𰒼	rdg
𰒽	rdnt
𰒾	rssj
𰒿	raqn
𰓀	rgxy
𰓁	rxxn
𰓂	ray
𰓃	rdcy
𰓄	rtay
𰓆	rqng
𰓇	rpy
𰓈	rynt
𰓋	rhvg
𰓌	rgkh
𰓍	rafg
𰓎	rskg
𰓏	rdkg
𰓑	rlh
𰓒	rjnn
𰓓	rtym
𰓔	ruwy
𰓕	rudy
𰓖	rxjh
𰓗	rdfy
𰓘	ramy
𰓚	rdhb
𰓜	rabh
𰓝	rjgh
𰓞	rtey
𰓟	rvsy
𰓠	rwfc
𰓡	rwvt
𰓢	rugy
𰓣	rpcy
𰓤	rytf
𰓦	rpwn
𰓧	rbiy
𰓨	rcsy
𰓩	rxbn
𰓪	rvgh
𰓫	ralh
𰓬	rgmy
𰓭	rfny
𰓮	rsgs
𰓯	rgki
𰓰	rdww
𰓱	rjcf
𰓳	rrfh
𰓴	rqgy
𰓵	rtdh
𰓷	rugg
𰓸	rynk
𰓹	ryai
𰓺	rahh
𰓻	rfwq
𰓼	rlrh
𰓽	rajg
𰓾	rlmh
𰓿	rhxf
𰔀	rawx
𰔁	rrhi
𰔂	rudj
𰔃	rifc
𰔅	rgng
𰔆	rdlf
𰔇	rgkh
𰔈	rfay
𰔉	rglg
𰔊	rans
𰔋	rkhm
𰔌	radk
𰔍	rrhk
𰔎	rtdi
𰔏	rpwc
𰔐	reto
𰔑	rvgp
𰔒	radd
𰔓	rdhc
𰔔	rgqo
𰔖	rtdp
𰔗	rrid
𰔘	reng
𰔙	rtec
𰔚	rpqq
𰔛	rouf
𰔜	ryke
𰔝	rcdi
𰔞	rcgt
𰔟	rfuy
𰔠	rmmm
𰔡	rltk
𰔢	rwvm
𰔣	rwym
𰔤	ryhq
𰔦	reph
𰔧	rtay
𰔨	rpqy
𰔩	rygl
𰔪	rssh
𰔫	rgbm
𰔬	rduo
𰔮	reln
𰔯	rqhu
𰔰	rris
𰔱	rutp
𰔲	rpag
𰔳	rdwf
𰔴	ruud
𰔵	rerc
𰔵	rqrc
𰔷	rylf
𰔸	raan
𰔹	rtfn
𰔺	rtcy
𰔻	remj
𰔼	ryni
𰔽	raky
𰔿	rlxy
𰕓	riet
𰕞	ryhy
𰙂	rxxq
𰙄	rlgs
𰙈	rlgs
𰙮	rtfh
𰚻	rnxv
𰚼	rnfc
𰚽	rnqr
𰚾	rnfi
𰚿	rnhd
𰛀	rnfk
𰛁	rnla
𰛂	rnqq
𰛃	rnwj
𰛣	rvyi
𰞐	riou
𰞟	roou
𰞼	rbio
𰟇	rsgo
𰟼	rhyx
𰟽	rhyk
𰠅	rhym
𰢛	rhny
𰢜	rcyn
𰢝	rcye
𰢞	rcyq
𰢠	rcyh
𰤒	rnb
𰤓	rnrt
𰤔	rvb
𰤕	rqiy
𰤖	rjh
𰤗	rynw
𰤙	rrrf
𰤝	raui
𰥰	rhqc
𰥶	rhkr
𰦈	rhqf
𰭂	rmwy
𰭃	rmcy
𰭄	rmxm
𰭅	rmyi
𰭆	rmay
𰭇	rmll
𰰕	rqcv
𰱕	ragf
𰲚	rhaw
𰲝	rhah
𰳒	rqcj
𰴐	rwhq
𰸈	rvyh
𰺶	rcyp
𰺸	rtap
𰺺	repi
𰻄	repd
𰻙	rpas
𰻷	rvnc
𰼚	rtdf
𰼷	ruqf
𱂡	rndm
𱂮	rtfm
𱂳	rgdm
𱅊	rvyg
𱆗	rqca
𱆙	rqcq
𱆚	rqcm
𱆞	rqcf
𱆟	rqch
𱆠	rqcf
𱇹	rmhg
𱈞	rwvo
𱉚	rwqg
𱉫	riqg
𱊑	rfhg
𱊙	rdfg
𱊯	rytg
𱌸	rmhb
𰒽	rdnn
𰓊	rlwy
𰓐	rkqy
𰓥	rytc
𰓪	rvfh
𰔐	ryto
𰔑	rvfp
𰔭	rakl
𰞠	rymo
𰥶	rhkq
𱆟	rqck
𰑆	rhnu
𰀽	snb
𰀾	snd
𰂤	swwf
𰂿	swwp
𰃄	swwj
𰅃	sqsv
𰉹	swcf
𰋗	ssqi
𰌩	swwb
𰎕	smcn
𰏐	ssnb
𰏣	sguf
𰏪	sdfj
𰐌	sqqa
𰑩	swcn
𰒛	sfpn
𰗒	scu
𰗓	syt
𰗖	swxn
𰗗	swbt
𰗙	sqvg
𰗚	spgg
𰗛	scfh
𰗝	sfmg
𰗟	sqbq
𰗠	stmh
𰗡	sutt
𰗢	splh
𰗤	spgf
𰗦	snyu
𰗨	sjfy
𰗫	sknf
𰗬	stfp
𰗮	spsy
𰗯	spwf
𰗰	snsy
𰗱	sdyp
𰗲	shlq
𰗴	styg
𰗵	spjh
𰗶	silg
𰗸	sbdi
𰗹	svij
𰗺	sfam
𰗻	sgov
𰗼	sjtg
𰗽	sjug
𰗾	stds
𰘀	sgkh
𰘁	sitq
𰘂	sody
𰘃	scbh
𰘄	sbgn
𰘅	sxtk
𰘆	sbjb
𰘇	sgkh
𰘈	sawl
𰘌	swqg
𰘍	swge
𰘎	stfc
𰘏	sivs
𰘔	spyd
𰘕	svqc
𰘖	sadi
𰘗	sfyt
𰘘	ssyn
𰘙	sgnj
𰘚	ssgo
𰘛	smay
𰘜	sltk
𰘝	swvm
𰘟	srie
𰘠	suqv
𰘢	spbc
𰘣	sxrh
𰘥	sgmi
𰘧	sfke
𰘩	savi
𰘫	sjge
𰘮	srns
𰘯	sxtk
𰘰	sxdx
𰘲	sbjr
𰘳	sgkm
𰘴	sduo
𰘵	sfdl
𰘶	sqgt
𰘷	spaf
𰘸	sovt
𰘹	suqm
𰘺	sygi
𰘻	sgmd
𰘽	sjxo
𰘿	sjaf
𰙀	suls
𰙆	ssli
𰙚	shg
𰙬	swwh
𰚤	sftn
𰚨	swwn
𰚯	sfin
𰛾	swwi
𰞽	sbio
𰟛	sqqo
𰟣	sjgo
𰠁	swwy
𰢥	svgy
𰨘	sfiy
𰮫	ssmw
𰱷	swwx
𰳖	skjj
𰴆	sfne
𰴋	sffv
𰴌	svnw
𰴍	svoi
𰻎	swwp
𰻼	ssjb
𰼃	sghg
𰼄	sgta
𰼅	sgch
𰼇	sgpc
𰼈	sgnb
𰼉	sgcc
𰼊	sgag
𰼋	sgal
𰼌	sgdd
𰼎	sgcc
𰼏	sgjl
𰼐	sgdl
𰼑	sgaw
𰼒	sgdf
𰼓	sgfj
𰼔	sgxk
𰼕	sgsf
𰼖	sgpl
𰼽	shqf
𱂺	sfim
𱆋	skgh
𱈮	sswo
𱈴	sveo
𱈵	snwo
𱈾	sjgo
𱉴	snrg
𱋃	swwj
𱌥	swwb
𰗗	swen
𰗥	slpy
𰼈	sgvb
𰀑	tfct
𰀫	tnv
𰀴	tfnn
𰀵	tmnk
𰀹	tnb
𰁆	tdkn
𰃖	tyfj
𰃗	tyfe
𰃘	tyid
𰃚	tylj
𰃜	tyas
𰃞	tuu
𰃦	tmv
𰄑	tyhg
𰄩	thjh
𰄰	tfpj
𰆁	taaf
𰆍	tfbh
𰆏	thbj
𰆒	tobj
𰆰	ttcu
𰆺	thfc
𰇄	tjtc
𰇌	takf
𰈗	tdkx
𰈧	temk
𰈳	tydk
𰊯	ttjf
𰋎	teu
𰋥	tqtd
𰎨	tvym
𰏛	tmhl
𰐤	tgtv
𰐦	tet
𰐬	tkh
𰐭	trg
𰐮	tfhg
𰐯	tksy
𰐰	tgjy
𰐱	thic
𰐲	tqaj
𰐳	tvud
𰐴	tgct
𰐵	tmwk
𰐶	txth
𰐷	tjlc
𰐸	tjxf
𰐹	thif
𰑎	tyfn
𰑢	tmdn
𰑣	tfkn
𰒁	tonn
𰓶	tjrj
𰕈	tdjt
𰕚	tgyy
𰕜	thay
𰕝	tfrh
𰖨	tdkf
𰗿	tigs
𰙃	tjgs
𰙺	tedh
𰚍	tfnu
𰚎	tfnx
𰚐	tfnc
𰚑	tfnv
𰚒	tfnh
𰚓	tfnm
𰚕	tfnk
𰚘	tfnb
𰚙	tfno
𰚚	tfnk
𰚛	tfnf
𰚜	tfnb
𰚝	tfny
𰚟	tfnf
𰚡	tfnf
𰚣	tfnu
𰚥	tvdn
𰚧	tfno
𰚬	tfnw
𰚲	tfnw
𰚴	tfns
𰛆	tii
𰜂	thip
𰝻	tfou
𰞓	tfou
𰞘	tgso
𰞲	tlou
𰠙	thgy
𰠚	thgy
𰠛	thgy
𰠜	thgt
𰠝	thgy
𰠟	thge
𰠦	trcy
𰠩	trfc
𰠫	trmq
𰠭	trfi
𰠮	trdt
𰠮	trdq
𰠱	trmd
𰠲	trca
𰠳	trgg
𰠴	traq
𰠶	trqf
𰠷	trvi
𰠸	truh
𰠸	truk
𰠹	trlc
𰠻	trol
𰠼	trkm
𰡸	tlgf
𰢟	tvry
𰢬	tgkn
𰢭	tgfk
𰢯	tggi
𰣒	tfcl
𰣓	tolr
𰣗	tmol
𰤛	tdkr
𰤥	tkhc
𰤵	tflf
𰤿	thgl
𰥚	thg
𰥥	tchf
𰦒	tfwu
𰦓	tdhy
𰦔	tdmq
𰦕	tdnw
𰦖	tdtd
𰦗	tdff
𰦘	tdkk
𰦙	tdkk
𰦚	tdhd
𰦛	tdgn
𰦜	tdlc
𰦝	tddk
𰦞	tdad
𰦟	tdgf
𰦡	tdgd
𰦢	tdqj
𰦣	tdtw
𰨛	tvt
𰨜	tyt
𰨝	tdf
𰨞	tvfh
𰨟	tgmf
𰨠	tkry
𰨡	tlh
𰨢	twbn
𰨣	ttuf
𰨤	tngk
𰨥	ttfq
𰨦	tyjh
𰨧	tynk
𰨨	tvvg
𰨪	tffn
𰨫	tmcn
𰨬	tqhj
𰨭	tlvg
𰨮	tojf
𰨯	tyny
𰨰	ttky
𰨱	tdkk
𰨲	thst
𰨳	tuqm
𰨴	tomc
𰨶	thko
𰨷	tpnm
𰨸	tfwj
𰨹	twym
𰨺	tpty
𰨻	tvfj
𰨼	tkhk
𰨽	tccg
𰨾	tddj
𰩀	tpgn
𰩁	tugy
𰩂	tguf
𰩃	thhy
𰩬	tdu
𰩭	tmj
𰩮	tfny
𰩯	tgmh
𰩰	taqb
𰩱	tmff
𰩲	thnr
𰩳	tjnb
𰩴	tkqb
𰩵	tej
𰩶	ttdc
𰩷	tnff
𰩸	ttdj
𰩹	tinr
𰩺	txqy
𰩻	tfpu
𰩼	tgva
𰩽	tfry
𰩾	tkdu
𰩿	tfqk
𰪀	tgji
𰪁	tmhr
𰪂	tdjd
𰪃	tpuv
𰪄	tyjf
𰪅	tglf
𰪆	trtd
𰪇	tsgv
𰪈	tsjg
𰪉	thko
𰪊	tqkh
𰪋	tqtj
𰪌	teyi
𰪍	tujf
𰪎	typq
𰪏	tltk
𰪐	tqln
𰪐	tqlr
𰪑	twar
𰪓	tpge
𰪔	tgit
𰪕	txdm
𰪖	tiwy
𰪗	tsss
𰪘	tnni
𰪙	tnky
𰪚	thtf
𰪛	tjtp
𰪜	ttel
𰪝	tuaw
𰪞	tsad
𰪟	trat
𰪠	thae
𰪡	ttql
𰪢	txya
𰪣	tyny
𰪤	ttof
𰪥	tqhe
𰭦	tolg
𰭰	tfia
𰯇	tule
𰯴	thmh
𰯵	thxj
𰯶	thaf
𰯷	thdg
𰯻	tfvp
𰯽	tdhh
𰯾	tdnt
𰯿	tdhc
𰰀	tdld
𰰁	tdkk
𰰂	thfk
𰰃	tdqq
𰰄	tdvo
𰰅	tdvn
𰰆	tduf
𰰇	tddf
𰰈	tdee
𰰉	tdwn
𰰋	tecc
𰰌	teqv
𰰍	tewc
𰰏	tegh
𰰐	teaf
𰰑	teov
𰰒	tegg
𰰓	tewp
𰰙	tgjc
𰳨	tlgj
𰳩	tlst
𰳪	txfh
𰳫	tmgs
𰳬	thhs
𰳭	txhs
𰳮	thys
𰳯	thfs
𰶚	tfwu
𰷳	tdhg
𰷻	tdhw
𰷿	tdhk
𰸺	tmdc
𰸻	tmdx
𰸼	tmdw
𰸽	tmdt
𰸾	tmdf
𰸿	tmdq
𰹀	tmdf
𰹁	tmdh
𰹂	tmdk
𰹃	tmdk
𰹄	tmdj
𰹅	tmdf
𰹆	tmdc
𰹇	tmdv
𰺧	tfqu
𰻇	tjtp
𰻘	tmtp
𰻭	tbbh
𰻿	twic
𰼀	tfqb
𰼗	tofj
𰼜	tgjc
𰼞	tgjq
𰿋	tcde
𱁯	tfnd
𱂛	tehm
𱂞	thpm
𱂟	twgm
𱂠	tadm
𱂥	tkdm
𱂶	tlqm
𱄎	tjfc
𱄏	tjye
𱄐	tjtp
𱈑	tmgt
𱈸	tgao
𱉛	tdqg
𱉬	tdjg
𱉮	tkqg
𱉷	twcg
𱊃	tqtg
𱊔	tjtg
𱊢	tuqg
𱋵	twii
𱌄	tdkn
𱌑	thlh
𱌒	thly
𱌓	thlr
𱌔	thlg
𱌕	thld
𱌖	thle
𱍇	tuqn
𰀭	tuxl
𰄑	tymg
𰐦	tret
𰞘	tfho
𰠞	thgq
𰠪	trdb
𰠬	trbn
𰠯	trda
𰠰	trgo
𰠵	trye
𰨧	tynq
𰨪	tfnf
𰨿	tyuo
𰪎	typm
𰪓	tpfe
𰪔	tfit
𰪙	tnhy
𰳩	tlsq
𰻘	tmop
𱌕	thlw
𰃝	ugny
𰃣	uwgk
𰃤	udyf
𰃥	usvg
𰃵	ufh
𰃶	umqy
𰃷	uwbn
𰃸	uynt
𰃹	uug
𰃺	uhcy
𰃻	uxxf
𰃼	ugxw
𰃽	uqjg
𰃿	ufnd
𰄀	urug
𰄁	ucde
𰄂	ufak
𰄃	udjf
𰄄	uuej
𰄅	ufpi
𰄆	uipq
𰄇	uwyx
𰄈	ufvg
𰄉	ukhe
𰄊	unrg
𰄋	ukhi
𰄌	ueaj
𰄍	ufup
𰄎	ueve
𰄏	uqoj
𰄣	uxvb
𰄦	uvr
𰅋	uxln
𰅼	ugso
𰅿	ugfe
𰇈	uknb
𰉗	ufd
𰉢	uff
𰊈	uqff
𰊉	ugef
𰋰	udmj
𰍤	uepy
𰍬	ujnt
𰎇	ugun
𰏎	ugaq
𰐧	uet
𰐨	uaet
𰑑	uvnu
𰑻	ukhn
𰒚	ujnk
𰕕	ujft
𰗀	ulgj
𰗃	uljj
𰗄	uef
𰘒	ubts
𰚄	uqmc
𰚗	uatn
𰚢	uktn
𰚱	ugln
𰜾	uifu
𰝉	ulji
𰞆	uxnw
𰞙	uqou
𰞚	utoi
𰟠	udgo
𰟷	uaco
𰠗	ubg
𰢷	umd
𰣄	ulh
𰣢	umqi
𰣣	ukhk
𰣤	umyd
𰣥	uwvv
𰣦	uyly
𰣨	ucci
𰣩	upsk
𰣪	uvci
𰣫	uigw
𰣬	uyjk
𰣭	ujvd
𰣮	uqeh
𰣯	uujd
𰣰	uoed
𰣲	uild
𰣳	uceg
𰣴	uuvd
𰣵	umdj
𰣶	ukhm
𰣷	umjk
𰣸	uqbn
𰣹	uejg
𰣺	ugmw
𰣻	uskk
𰣼	utkw
𰣽	uyor
𰣾	ukkl
𰣿	ujpx
𰤀	ueuq
𰤂	ufje
𰤃	uwyo
𰤄	uwwj
𰤆	ugfl
𰤇	uqed
𰤈	ufnf
𰤉	ussi
𰤋	utao
𰥁	uglh
𰥂	ugln
𰥄	uglk
𰥅	uwlq
𰥊	ujtl
𰩡	uwff
𰩢	ugcy
𰩣	uwsy
𰩤	uuqy
𰩥	udmd
𰩦	ujhg
𰩨	utgf
𰩪	ultk
𰩫	uhqq
𰪒	utdy
𰭗	udmn
𰭘	ugmw
𰭙	udua
𰭚	udov
𰭛	ugdy
𰭜	udhh
𰮔	uxmw
𰰝	uqu
𰰣	uxhj
𰰦	uitr
𰱋	uxtu
𰳝	umij
𰴘	ujmq
𰶩	udve
𰷝	ujtm
𰸏	uqwh
𰹌	ulh
𰺥	uvyy
𰺦	ubty
𰺨	ugmb
𰺩	udgy
𰺪	uumw
𰺫	uuvo
𰻅	ukpd
𰻓	utdp
𰼍	usgx
𰽑	uquh
𰿗	uhi
𰿘	udne
𰿙	uqyi
𰿚	uqi
𰿛	uuhk
𰿜	uqre
𰿝	uui
𰿞	uqjk
𰿟	udhf
𰿠	ugad
𰿡	uwga
𰿢	upwa
𰿣	ufff
𰿤	uiay
𰿥	uhk
𰿧	uvd
𰿨	ufqv
𰿩	uaht
𰿪	uwve
𰿫	uyly
𰿬	uguf
𰿭	uld
𰿮	uthd
𰿯	ugku
𰿰	utmt
𰿱	ueed
𰿲	ujxx
𰿴	ujqn
𰿵	uwgj
𰿶	upwt
𰿷	ufii
𰿸	uthd
𰿹	uamw
𰿺	uipf
𰿻	uwgn
𰿼	uulj
𰿾	unku
𰿿	ugak
𱀀	usgt
𱁉	ufwy
𱁊	ukhy
𱂇	udyh
𱂐	ujkm
𱂑	ujea
𱂒	ujjy
𱂓	ujwk
𱂗	ugdm
𱂦	uadm
𱃮	ugwy
𱄋	uthf
𱅑	udyc
𱆓	ugoh
𱉯	udqg
𱊰	ujng
𱌇	umin
𱌲	udhb
𱌾	uegw
𱍈	umin
𰃤	udwf
𰃾	uyve
𰄎	uqve
𰄺	upmj
𰅇	umdv
𰅋	uxlt
𰅼	ufso
𰅾	upya
𰅿	uffe
𰏎	udah
𰚄	uqic
𰚇	umdc
𰣧	ulwi
𰣮	uqek
𰥁	ugli
𰿘	udnv
𰿽	usym
𱁊	usky
𱃆	ukmj
𱃮	udyy
𱈬	ubwo
𰯹	vjsu
𱆎	vgkh
𱊈	vqqg
𱌅	vqkn
𰀅	vygf
𰀻	vknn
𰁇	vgiy
𰄛	vqyy
𰄡	vqrt
𰄤	vqnn
𰄥	vyyy
𰄧	vgqj
𰄫	vtmk
𰄮	vgiy
𰄶	vcde
𰄷	vrtd
𰄸	vmjh
𰅀	vsss
𰅁	vpdj
𰅓	vcal
𰊀	vckf
𰋵	vyi
𰋶	vln
𰋶	vlt
𰋸	vnrt
𰋹	vfny
𰋺	voy
𰋻	vnt
𰋼	vtdc
𰋾	vxxf
𰋿	vdjg
𰌁	vmgm
𰌂	vhmy
𰌃	vwhg
𰌄	vdpy
𰌇	vgmy
𰌈	vfhg
𰌉	vkjn
𰌊	vaqq
𰌋	vug
𰌍	vdud
𰌎	veck
𰌏	vmeg
𰌐	vajh
𰌒	vtln
𰌓	vbuh
𰌔	vouf
𰌖	vpnl
𰌗	vbud
𰌙	vgkm
𰌛	vrin
𰍦	vfas
𰏄	vjj
𰏆	vlpe
𰏏	vtkn
𰏑	vmhh
𰐈	vaj
𰐣	vruf
𰐥	vowv
𰒱	vjsa
𰗂	vfje
𰙊	vfqw
𰙑	vijw
𰙜	vyhf
𰙨	vfhf
𰙩	vyvh
𰞞	vvou
𰟅	vcao
𰠣	vbat
𰤘	vbrf
𰭯	vcaj
𰭺	vcbf
𰭼	vgnv
𰭽	vftj
𰳣	vgkj
𰴖	vkmq
𰴙	vtkq
𰴟	vef
𰷧	vhgm
𰻌	vfip
𰻕	vfjp
𰻚	vtkp
𰻸	vfbe
𰼆	vcsg
𱂕	vfdm
𱄍	vdhg
𱇫	vkqg
𱉈	vqyg
𱉝	vcqg
𱉼	vcbg
𱊎	vlqg
𰁇	vfiy
𰄮	vfiy
𰇯	vfbk
𰌓	veuh
𰯸	vssu
𰯺	vllv
𱈷	vhco
𱌍	vnuq
𱌎	vnuw
𱌏	vnul
𱌐	vnuo
𰔶	wflr
𰯼	wfmj
𱊭	wfgg
𰀮	wnni
𰀿	wanb
𰁡	wtyy
𰁢	wnt
𰁣	wxn
𰁥	wmcy
𰁦	wty
𰁧	wwwy
𰁨	wthn
𰁩	wufk
𰁪	wccy
𰁫	wrsh
𰁬	wmdy
𰁭	wenn
𰁯	wyni
𰁱	wdnn
𰁲	wfmg
𰁳	warh
𰁴	wfgf
𰁵	wfbg
𰁶	wamy
𰁷	wjhn
𰁸	wivg
𰁹	wjh
𰁺	whmq
𰁻	wkmh
𰁼	wtmk
𰁽	wjwj
𰁾	wqmy
𰁿	wlkf
𰂀	wrgk
𰂁	wyjh
𰂂	wiag
𰂃	wvfy
𰂄	wxwg
𰂅	wgkm
𰂆	wfnf
𰂇	wmy
𰂈	whiv
𰂉	wtey
𰂊	wqdk
𰂋	wujg
𰂌	wrnk
𰂍	wcic
𰂎	wueg
𰂏	wfnd
𰂐	wdwv
𰂑	wgmy
𰂒	wmum
𰂓	wtfx
𰂔	wywu
𰂕	woef
𰂖	wxjh
𰂗	wgkh
𰂘	wdud
𰂙	wgtj
𰂚	wgje
𰂛	wmff
𰂜	wkhm
𰂝	whgf
𰂞	wrnw
𰂟	wgng
𰂠	wxfy
𰂡	wccf
𰂢	wsny
𰂣	wsyt
𰂥	wstl
𰂦	whan
𰂧	wkwf
𰂨	wwnp
𰂩	wpyg
𰂪	wmty
𰂫	witr
𰂬	wqjg
𰂭	wmjr
𰂮	whfh
𰂯	wtvg
𰂰	wuoj
𰂱	wipr
𰂲	wipq
𰂳	wplp
𰂴	wwqb
𰂵	wton
𰂶	wyje
𰂷	wuqm
𰂸	wule
𰂹	wpax
𰂺	wgck
𰂻	weum
𰂼	wukq
𰂽	wxjj
𰂾	wddj
𰃀	wptl
𰃁	wybo
𰃂	wfko
𰃅	wxtm
𰃆	wtfm
𰃇	wnlw
𰃈	wxji
𰃉	wjym
𰃠	wcmw
𰃢	wgnj
𰄙	wjh
𰄱	wvsg
𰅞	wdqn
𰅭	wfj
𰅻	wxfl
𰆿	wwnc
𰇴	wgku
𰋬	wwkd
𰎧	wnnm
𰏘	wmiw
𰏙	wnnh
𰏤	wwga
𰏥	wjrf
𰐼	wnu
𰒠	wwkn
𰔾	wgkh
𰕌	wyty
𰕑	wgst
𰕔	wwft
𰖃	wwwj
𰖗	wgoj
𰖲	wgkj
𰙎	wgiw
𰙓	wdcw
𰙘	wgkw
𰜅	wkki
𰟗	wgjo
𰟩	wgko
𰠋	wqdt
𰠌	wqdy
𰤌	wdu
𰤍	wxb
𰤎	wxhj
𰤏	wjnb
𰤐	wgkg
𰤑	wytu
𰧂	wynd
𰧲	wxfi
𰨇	wyfi
𰫶	wlgx
𰭶	wqbf
𰮀	wmww
𰯥	wwgw
𰰘	wync
𰳑	whtj
𰶐	wwwk
𰶑	wwky
𰶓	wwkj
𰶔	wwkd
𰶕	wwkd
𰶛	wdgu
𰷄	wgmu
𰷔	wjfm
𰸍	whkh
𰻉	wgkp
𰻑	wkkp
𰻥	wxbh
𰼡	wvqf
𱀁	wnnf
𱀂	wnnb
𱀅	wnnw
𱀈	wnnf
𱀉	wnnk
𱀓	wnne
𱀖	wnnt
𱀘	wnnt
𱀜	wnny
𱀝	wnnf
𱀟	wnnb
𱀮	wnni
𱀳	wnnm
𱁃	wnnf
𱁄	wnnn
𱁅	wwyf
𱁆	wygc
𱁋	wyth
𱁎	wyny
𱂝	wyom
𱂫	wgim
𱂭	wydm
𱂻	wyom
𱃡	wyvf
𱃢	wyvn
𱃣	wyvh
𱃤	wyvn
𱃥	wyvj
𱃦	wyvj
𱃧	wyvq
𱃨	wyvh
𱃩	wyvj
𱃪	wyvw
𱃫	wyve
𱃬	wyvk
𱃭	wyvq
𱃯	wyvl
𱃰	wyvu
𱆣	wqou
𱇱	whtg
𱈝	wvgn
𱈣	wvgg
𱈨	wvgy
𱈪	wvgv
𱈫	wvgf
𱈰	wvgk
𱉁	wvgy
𱉆	wvgi
𱉑	wvqg
𱉜	wfqg
𱊛	wyfg
𱊣	wyng
𱊵	wgkg
𱍉	wgkn
𱍊	wgkj
𰂌	wynk
𰂞	wynw
𰏥	wjrh
𰙓	wdqw
𰠋	wqdy
𰠍	wqhc
𰢡	wfey
𰥇	wfgl
𰁰	xjwu
𰅢	xxqw
𰅵	xqbf
𰅺	xfmf
𰇉	xkf
𰊿	xfuf
𰏯	xqb
𰏰	xngg
𰐉	xxaj
𰐓	xkfg
𰐔	xjgg
𰐕	xxxj
𰐖	xjat
𰐗	xgey
𰐘	xkfl
𰐙	xgah
𰐚	xqgg
𰐛	xufq
𰐜	xmdj
𰐝	xjgy
𰐞	xyji
𰐟	xajd
𰑓	xanu
𰒨	xawi
𰕛	xuxy
𰕡	xyrh
𰕽	xjf
𰘱	xdjs
𰟆	xfko
𰠺	xqrg
𰣅	xlf
𰥆	xttl
𰦠	xtdm
𰫗	xtyy
𰫘	xynn
𰫙	xbg
𰫚	xgmh
𰫛	xqcy
𰫜	xwvn
𰫝	xvtt
𰫞	xdxy
𰫟	xkgn
𰫠	xlh
𰫡	xtgg
𰫣	xnkg
𰫤	xvey
𰫦	xwtf
𰫧	xpsy
𰫨	xckg
𰫩	xawx
𰫪	xlmh
𰫫	xltu
𰫬	xrmj
𰫭	xonc
𰫮	xyde
𰫯	xypq
𰫰	xtvt
𰫲	xypy
𰫳	xfhk
𰫴	xlsu
𰫵	xddj
𰫷	xqoj
𰫸	xpdn
𰫺	xpwx
𰫼	xsh
𰫽	xgiy
𰫾	xfqn
𰫿	xkhh
𰬀	xwjh
𰬁	xynt
𰬂	xskg
𰬃	xgmw
𰬄	xdlg
𰬅	xwfy
𰬆	xqkg
𰬇	xygg
𰬈	xyxy
𰬉	xpxn
𰬊	xudg
𰬋	xxcy
𰬌	xghg
𰬍	xgud
𰬎	xxxf
𰬏	xriy
𰬐	xtdj
𰬑	xqvh
𰬒	xuqw
𰬓	xynw
𰬔	xuah
𰬕	xevg
𰬕	xivg
𰬖	xdny
𰬗	xgiy
𰬘	xfpb
𰬙	xdfe
𰬚	xkmy
𰬛	xeet
𰬜	xqkq
𰬝	xujg
𰬞	xvpc
𰬟	xakg
𰬠	xglb
𰬡	xgvh
𰬢	xgvv
𰬣	xjqr
𰬤	xrtf
𰬥	xwcn
𰬦	xqrn
𰬧	xooy
𰬨	xblg
𰬩	xvij
𰬪	xcde
𰬫	xgct
𰬬	xalg
𰬭	xfff
𰬮	xdpg
𰬯	xqbt
𰬰	xqrn
𰬱	xfpi
𰬲	xdri
𰬳	xubp
𰬴	xpuh
𰬵	xyth
𰬶	xnrg
𰬷	xaet
𰬸	xgjn
𰬹	xwym
𰬺	xusf
𰬻	xcbk
𰬼	xgkm
𰬽	xqeg
𰬾	xyuo
𰬿	xwow
𰭀	xdet
𰭁	xatn
𰭪	xftx
𰮴	xuxe
𰳚	xwyj
𰶳	xxmu
𰹫	xlxm
𰺳	xpv
𰻱	xdkc
𰻳	xjmb
𱁈	xtwy
𱅀	xfcg
𱆊	xobx
𱆐	xfch
𱆑	xgdh
𱆒	xdgh
𱆔	xrwh
𱆕	xalh
𱉞	xgug
𱉢	xlqg
𱊐	xxrg
𱊘	xeqg
𰐛	xudn
𰙂	xrxq
𰚌	xxyc
𰫢	xqsy
𰫯	xypm
𰫺	xpwi
𰭪	xgux
𱂼	xxmj
𰇺	yvwk
𰈴	yssx
𰊤	yaof
𰏲	ycd
𰏳	yjhk
𰏴	yufk
𰏶	ywfc
𰏷	ystc
𰏹	ydwg
𰏺	ytdk
𰏼	ygkh
𰏽	yguf
𰏾	yrvc
𰏿	ylpi
𰐁	yyve
𰐂	yacq
𰐃	yfwl
𰐄	yacp
𰐅	yvhg
𰑸	ygun
𰢍	yssy
𱊝	yvhg
𱊤	yveg
𱋱	yssm
𱌈	yssn
𰀩	ygyg
𰀺	ynin
𰁜	you
𰁝	ynee
𰁞	ylff
𰁟	ynik
𰁠	ypql
𰄢	yvt
𰄺	yupj
𰅇	yumv
𰅾	yupa
𰆴	yhcu
𰇟	ymik
𰈛	yvrk
𰈽	ykqs
𰏸	yljf
𰏻	yihc
𰐀	yrwe
𰐆	ynjd
𰐡	yoxm
𰐪	yket
𰒃	ytrn
𰒊	ytfn
𰒰	yuma
𰒵	ynyk
𰒶	ynyy
𰓉	yrj
𰕆	yhcy
𰕍	ytkh
𰕎	ycet
𰕧	yxjh
𰕨	yqiy
𰕩	yieg
𰕪	yebg
𰕫	yyve
𰕬	ytjf
𰕭	ytwc
𰕮	ytwf
𰕯	ytni
𰗣	ywws
𰗭	ycbs
𰘡	ytns
𰙙	yigw
𰙪	yuph
𰙲	yuph
𰙷	yumh
𰚇	yumc
𰚫	ymkn
𰚳	yotn
𰛪	yoiu
𰜊	ylki
𰟳	ywyo
𰡦	yumy
𰡲	ygyu
𰢾	ylwu
𰣡	ynlh
𰥐	yhgf
𰥠	yohf
𰥲	ynhh
𰧿	yjfi
𰫹	yxxf
𰮑	ycmw
𰯜	yner
𰲱	yju
𰴩	yvt
𰴫	yfiy
𰴮	ygjg
𰴰	ykkg
𰴲	yubt
𰴳	ypiy
𰴵	yutt
𰴶	ybig
𰴷	yxty
𰴹	yjcf
𰴺	ypsy
𰴻	yuny
𰴼	yhwy
𰴽	yudb
𰴾	yddy
𰵀	yqyg
𰵁	yqte
𰵂	yovg
𰵃	yukq
𰵄	ycwy
𰵅	ypoo
𰵆	ykkt
𰵇	ywym
𰵈	ytff
𰵉	yalq
𰵊	ynhh
𰵋	ytfh
𰵌	ynrt
𰵍	ygbn
𰵎	ydny
𰵏	yitt
𰵐	yrcy
𰵑	yyly
𰵒	ypqn
𰵓	ysyy
𰵔	yann
𰵕	ygcy
𰵖	yann
𰵗	ymdy
𰵘	ymfg
𰵙	yrwy
𰵚	ywyc
𰵛	yqkg
𰵜	yqnn
𰵝	yty
𰵞	yyni
𰵟	yudg
𰵠	yvcy
𰵡	ycag
𰵢	ygud
𰵣	ywgk
𰵤	ytkg
𰵥	yqqy
𰵦	yuqy
𰵧	yfny
𰵨	ygod
𰵩	ygey
𰵪	ymwk
𰵫	ygku
𰵬	yklj
𰵭	ytjh
𰵮	ytry
𰵯	ycwt
𰵰	yfuf
𰵱	yssy
𰵲	yadw
𰵳	yhjh
𰵴	yhic
𰵵	yvqn
𰵶	ytgf
𰵷	yccc
𰵸	yijg
𰵹	ybcc
𰵺	ydri
𰵻	yadn
𰵼	yqas
𰵽	yevg
𰵾	yexd
𰵿	yymk
𰶀	yffn
𰶁	ytqq
𰶂	ytln
𰶃	ynrg
𰶄	ydfj
𰶅	ythf
𰶆	ynbt
𰶇	ybde
𰶈	ynig
𰶉	yylg
𰶊	yujn
𰶋	ypan
𰶌	yfdj
𰶍	yqmt
𰶎	yvyh
𰶏	ywga
𰶲	ynmu
𰺽	yvep
𰻊	ymkp
𰻔	ytup
𰻜	yjyp
𰻦	ylyb
𰻯	yibh
𰼁	ybfc
𱂔	yndm
𱂜	yupm
𱂯	ywwm
𱂷	ytmm
𱂹	ynom
𱅝	ynmg
𱅴	ymks
𱅵	ymkm
𱅶	ymky
𱅷	ymkh
𱅹	ymkh
𱅺	ymkc
𱅻	ymkg
𱅼	ymkf
𱅾	ymkg
𱆝	ynyc
𱈧	yqao
𱈬	yubo
𱈱	yfwo
𱉓	ynqg
𱊋	yneg
𱊕	yupg
𱊥	yumg
𱊮	ynky
𱊾	ynjc
𱊿	ynjc
𱋀	ynjp
𱋁	ynjx
𱋂	ynjq
𱌗	yjou
𱌘	yjlf
𱌙	yjye
𰁠	ypml
𰈛	yvek
𰏿	ylp
𰒴	ynyq
𰡪	yssk
𰻽	yleb
𱋯	yssk
𱋰	yssw
