---config@码表分类=主码-10
---config@码表别名=CJKExt_I
𮵾	ahni
𮶛	aab
𮶜	adf
𮶝	ayqu
𮶞	anuu
𮶟	auff
𮶠	admh
𮶡	akfj
𮶢	aysu
𮶣	auwc
𮶤	aifc
𮶥	aiyn
𮶦	agtu
𮶧	awmh
𮶨	autu
𮶨	auti
𮶩	aqtd
𮶪	auqu
𮶫	aiju
𮶬	aqgu
𮶭	ayng
𮶮	apuc
𮶯	aghq
𮶯	agmq
𮶰	ajef
𮶱	aiyb
𮶲	anaj
𮶳	axwy
𮶴	awyn
𮶵	aipg
𮶶	aiuo
𮶷	aiaw
𮶸	agag
𮶹	aiui
𮷣	afqp
𮸮	afmq
𮹜	akug
𮹜	aukg
𮱝	bthn
𮶏	bqug
𮶐	bmg
𮶑	bgyy
𮶒	bffg
𮶓	batq
𮷫	blbh
𮸨	bgeg
𮸩	bjtg
𮸪	bqtk
𮰓	cnwy
𮷠	cfpd
𮷠	cfpi
𮷦	cbdp
𮹁	cqug
𮹂	cnuy
𮹃	cccy
𮹄	cgbn
𮹅	cgsy
𮹆	cnah
𮹇	ctaf
𮹈	cpdc
𮹉	cgeg
𮹊	ceeg
𮹋	cmfk
𮹌	cjlg
𮹍	cthn
𮹎	cjlc
𮹏	cfpu
𮹐	cjjj
𮰌	dejh
𮰍	diln
𮰑	divd
𮰒	dwwv
𮰵	dfkf
𮱑	dhqv
𮲌	djfa
𮲍	dakf
𮲎	ddmy
𮲎	ddmt
𮳿	dddd
𮵉	dqyy
𮵊	dfnh
𮵋	dtah
𮵌	dbnn
𮵍	dtdg
𮵎	dfff
𮵏	dgmf
𮵐	diqb
𮵑	dybh
𮵓	dmdg
𮵔	dqmd
𮵕	dadt
𮵕	dady
𮵖	dtky
𮵗	dytb
𮷞	dpk
𮷞	dpi
𮷨	dlbh
𮸤	dgdy
𮸴	dmmy
𮹝	dxdx
𮯱	etny
𮲪	ewfh
𮲫	etfq
𮶔	efnh
𮶕	eqfh
𮷄	epmq
𮷩	ebh
𮯰	fjd
𮰊	fomn
𮰏	fvqb
𮰐	fhxq
𮰙	fnd
𮰙	fnv
𮰚	fcyy
𮰛	fwfg
𮰜	fubh
𮰞	fqkg
𮰢	fgty
𮰣	fyff
𮰤	fhdy
𮰥	fqmd
𮰦	fdwd
𮰧	fjug
𮰨	fhjs
𮰩	faya
𮰪	fqrq
𮰫	fydn
𮰬	fjey
𮰭	fadn
𮰮	fmae
𮰯	fajl
𮰰	faj
𮰰	fajj
𮰱	fkft
𮰲	fiqb
𮰲	fqiu
𮲄	fcln
𮳕	fgei
𮴼	fmuy
𮷎	fckm
𮷑	fokm
𮸫	fmyu
𮸬	fgyu
𮹁	fhnu
𮯰	gjgd
𮰳	gogt
𮰼	givf
𮱜	gsbf
𮱣	gqkm
𮲆	gehn
𮲿	ghgh
𮴀	ggqn
𮴁	giy
𮴂	gyqy
𮴃	gbn
𮴄	gkhh
𮴅	gwxn
𮴆	gmqy
𮴇	gmcy
𮴈	gnyy
𮴉	gkwy
𮴊	gthy
𮴋	gymh
𮴌	gufg
𮴍	gbmh
𮴎	gcfg
𮴏	ggog
𮴐	gahh
𮴑	gguw
𮴒	gmnn
𮴓	gtdj
𮴔	gwxf
𮴕	gydy
𮴖	gukg
𮴗	gatq
𮴘	gdpy
𮴙	gfhy
𮴚	gjcf
𮴛	gwsk
𮴜	gran
𮴝	gqlg
𮴞	gntn
𮴟	gmwc
𮴠	ggmy
𮴡	gggf
𮴢	gjta
𮴣	gepc
𮴤	gbdi
𮴥	gmnm
𮴦	gtjt
𮴧	gwye
𮴨	gukn
𮴩	gthn
𮴪	gthd
𮴫	gwcn
𮴬	gssq
𮴭	gjde
𮴮	gnff
𮴯	gjey
𮴰	gpnm
𮴱	gaqo
𮴲	gade
𮴳	gfsy
𮴴	gipr
𮴵	gxkj
𮴶	gapk
𮴷	gxiy
𮴷	gxwy
𮴸	gawi
𮴹	gaui
𮴺	gyny
𮷋	gkul
𮷥	gdmp
𮸭	gewf
𮸰	gklh
𮹑	gkmk
𮵅	hyqy
𮵆	hfnh
𮵇	hgji
𮵈	hpws
𮶺	hahd
𮸺	hidh
𮰠	ivrf
𮰡	iwff
𮰴	idu
𮰴	igdu
𮱡	ibf
𮱢	idf
𮳃	iyqy
𮳄	iccy
𮳅	igog
𮳆	iwxf
𮳇	ipoy
𮳈	ibai
𮳉	isoy
𮳊	inck
𮳋	injy
𮳌	igsk
𮳍	iutk
𮳎	iuoy
𮳏	iptq
𮳐	ijde
𮳑	ihxr
𮳒	itft
𮳔	idwy
𮳖	ifmd
𮳗	ilwj
𮳘	iawj
𮳙	iauy
𮹛	ijyg
𮲗	jjyu
𮲚	jdnn
𮲛	jyqy
𮲜	jay
𮲝	jtdy
𮲞	jsgf
𮲟	jdmy
𮲠	jpgf
𮲡	jawu
𮲢	jyeu
𮲣	jmyy
𮲤	jqf
𮲥	jyps
𮲦	jvhc
𮲧	jmth
𮲨	jprw
𮲩	japy
𮶎	jyin
𮶻	jnui
𮶼	jfiy
𮶽	jyni
𮶾	jftb
𮷬	jogb
𮸶	judm
𮰔	kfnh
𮰖	kujy
𮰗	kjym
𮳯	kmlo
𮷏	kmqu
𮷒	khid
𮹖	kegg
𮰎	lham
𮰘	ltkd
𮲖	lyu
𮴽	lnn
𮴾	lfiy
𮴿	lqyg
𮵀	lwxf
𮵁	lwxf
𮵂	lqtg
𮵃	lybt
𮷖	lmn
𮷗	ldyy
𮷘	lrnn
𮷙	lqyg
𮷛	lllj
𮷜	luej
𮷝	levg
𮱤	mwbb
𮱥	mvfd
𮱥	mvff
𮱦	mmcu
𮱧	mwau
𮱨	mbf
𮱩	mplj
𮱪	mwai
𮱫	mrgw
𮱬	mqtd
𮱭	mmwc
𮱮	mwgb
𮱯	mujf
𮱰	mssh
𮱱	mmgo
𮱱	mmdo
𮱲	myuh
𮱲	myuj
𮱲	myuf
𮱹	mmge
𮲓	mty
𮲔	mnty
𮳀	mcty
𮷌	mhh
𮷍	mpsh
𮸵	mtdm
𮸻	mqjr
𮹗	mwyg
𮹙	mwyg
𮹚	mqyg
𮹚	mqqg
𮱂	nvf
𮱿	nqyy
𮲀	nmy
𮲁	nmqn
𮲂	nmqy
𮲃	nqiy
𮲅	nhmy
𮲇	nlgy
𮲈	nyvb
𮲉	nnhg
𮲊	nfke
𮲋	nwye
𮴽	nld
𮵒	ndf
𮶉	nufh
𮶊	nntr
𮶋	njy
𮶻	nuji
𮸽	nunu
𮱌	oovf
𮳚	ogfh
𮳛	onuy
𮳜	onug
𮳝	ogmh
𮳞	odsh
𮳟	oeg
𮳠	omqy
𮳡	omcy
𮳢	opgg
𮳣	oaiy
𮳤	oqkg
𮳥	oftx
𮳦	olkg
𮳧	otdj
𮳨	ovey
𮳩	ogty
𮳫	oafw
𮳬	olpy
𮳭	ogmy
𮳮	osoy
𮳰	oagh
𮳱	okhm
𮳲	oriy
𮳳	oukn
𮳴	ojwf
𮳵	opey
𮳶	oapy
𮳷	ofvg
𮳸	oapk
𮳹	oawj
𮵻	ouog
𮵼	oxoy
𮵽	oujh
𮸼	oooq
𮹘	oopg
𮰄	pdxb
𮰅	pwss
𮱞	pdnb
𮱟	pyu
𮱠	pwyk
𮵘	pywf
𮵙	pywx
𮵚	pycf
𮵛	pymj
𮵜	pywh
𮵝	pyal
𮵞	pypf
𮵟	pyur
𮶇	pwaj
𮷀	pugy
𮷁	pukm
𮷂	pupf
𮷃	punw
𮱅	qgvv
𮲱	qqqs
𮳪	qkqo
𮳽	qtrk
𮳾	qtyk
𮷡	qtdp
𮷢	qpd
𮷢	qpi
𮷯	qiqf
𮷰	qksy
𮷱	qpuv
𮷲	qwwh
𮷴	qfln
𮷵	qnn
𮷶	qyqy
𮷷	qdhh
𮷸	qfqn
𮷹	qfcy
𮷺	qty
𮷻	qmqy
𮷼	qmyg
𮷽	qcbh
𮷾	qann
𮷿	qfiy
𮸀	qanw
𮸁	qwta
𮸂	qeh
𮸃	qyni
𮸄	qadt
𮸅	qahh
𮸆	qydy
𮸇	qifh
𮸈	qplh
𮸉	qamy
𮸊	qtjh
𮸋	qwty
𮸌	qqdh
𮸍	qyig
𮸎	quny
𮸏	qcwt
𮸐	qayn
𮸑	qssy
𮸒	qjta
𮸓	qvws
𮸔	qdwj
𮸕	qgkl
𮸖	qjcl
𮸗	qjog
𮸘	qypm
𮸙	qdwt
𮸚	qldn
𮸛	qmgu
𮸜	qpgu
𮸝	qapy
𮸞	qadf
𮸟	qiph
𮸠	qpaq
𮸡	qooo
𮸢	qmgm
𮸣	qfde
𮸿	qney
𮹔	qyni
𮯲	rnv
𮲏	rgah
𮲐	rvyc
𮲑	rqkn
𮴻	rcyr
𮵄	rwyn
𮹒	rqcd
𮰝	svff
𮲬	sdyy
𮲭	swwu
𮲮	sccy
𮲯	snyw
𮲰	sxxf
𮲲	sydy
𮲳	shit
𮲴	swvc
𮲵	sqgg
𮲶	smgy
𮲶	smgt
𮲷	subg
𮲸	sudj
𮲹	slng
𮲺	sfkm
𮲻	spwh
𮲼	sted
𮲽	saks
𮷮	shjf
𮰃	tyfb
𮰕	tfkb
𮱜	tbf
𮱺	ttbn
𮱻	tcfg
𮱼	tmgh
𮱽	tlny
𮱾	tggn
𮳁	tfng
𮳂	tfnt
𮳂	tfny
𮳺	trcg
𮳻	trdl
𮳼	trnd
𮵠	tfnh
𮵡	tqkg
𮵢	thcy
𮵤	tadn
𮵫	tbj
𮵬	tgf
𮵭	tmqu
𮵮	tqyg
𮵯	tqbb
𮵰	tyth
𮵱	tgou
𮵲	tevf
𮵳	tpgy
𮵴	tsfc
𮵵	tdlf
𮵶	tpgy
𮵷	tivh
𮵸	tjjj
𮵹	ttvc
𮶌	tfqn
𮶖	thtu
𮶗	tefh
𮶘	tefc
𮶙	tejl
𮶚	teut
𮶚	teuj
𮶚	teuy
𮷓	tmdy
𮷔	tmdi
𮷟	tpi
𮷭	tjbh
𮹀	tjpw
𮰆	uxn
𮰇	urgh
𮰈	uaft
𮰉	ucmb
𮰶	uogd
𮲾	ujqw
𮵣	udwt
𮵣	uddt
𮵣	udtt
𮵥	udnn
𮵦	utuy
𮵧	udtf
𮵨	ugah
𮵩	udqq
𮵪	unrg
𮶍	ukhn
𮷕	udtt
𮷚	uflj
𮷧	umwp
𮷳	utfq
𮸥	ufkd
𮸦	uukd
𮸧	uube
𮸱	ujtn
𮸲	ujdn
𮸳	ujmc
𮸷	ujdm
𮰷	vgnn
𮰸	vyqy
𮰹	vgbn
𮰺	vqbh
𮰻	vmcy
𮰽	vqiy
𮰾	vufg
𮰿	vguw
𮱀	vtfh
𮱁	vnyu
𮱃	vlkg
𮱄	vlfq
𮱅	vvf
𮱆	vuyy
𮱇	vlph
𮱇	vlpy
𮱈	vgny
𮱉	vdyn
𮱊	vlqy
𮱋	vqde
𮱍	vvcb
𮱎	vdjb
𮱏	vqvn
𮱐	vyox
𮱒	vqye
𮱓	vybc
𮱔	vagw
𮱕	vapy
𮱖	vssq
𮱗	vjde
𮱘	vujf
𮱙	vgeh
𮱚	vhal
𮱛	vfkk
𮶈	vnd
𮷐	vtkm
𮯴	wqn
𮯵	wdnn
𮯶	wnn
𮯷	wcyy
𮯸	wdlt
𮯸	wdln
𮯹	wmcy
𮯺	wagn
𮯻	wcfg
𮯼	wsoy
𮯽	wjgd
𮯾	wbib
𮯿	wgee
𮰀	wdff
𮰁	wtjt
𮰂	wgkd
𮰂	wgki
𮰃	wfbb
𮱅	wfvv
𮱳	wxmh
𮷤	wdmp
𮷪	wgib
𮸯	wnnh
𮸾	wyvy
𮹕	wayg
𮹕	waqg
𮰋	xrxm
𮱴	xqcy
𮱵	xtdj
𮱶	xwgg
𮱷	xpvg
𮱸	xxyy
𮵿	xcyy
𮶀	xgyy
𮶁	xmmg
𮶂	xtdh
𮶃	xwhs
𮶄	xtux
𮶅	xpwk
𮶆	xqry
𮯳	yooo
𮰟	yoff
𮱜	ysbf
𮲒	ynkr
𮲕	ylty
𮲘	yjrh
𮲙	yqg
𮳓	ynki
𮵺	ynto
𮶿	yemw
𮷅	yaiy
𮷆	ylg
𮷇	yqiy
𮷈	ydsk
𮷉	yjqr
𮷊	ytol
𮸸	ynmm
𮸹	ynwm
𮹓	yqgf
