---config@码表分类=主码-1
---config@码表别名=CJK
劻	aglt
嬊	akuv
戉	anty
戔	aau
氋	apfn
瓨	agny
甌	akky
艻	alr
芀	avr
芿	awer
苆	aavr
苢	ahnn
苭	axlr
苺	axyy
茷	awau
荕	aelr
荗	adyy
荿	adny
莮	allr
菙	atfg
菚	aaau
葴	adgy
蒧	adhy
蔵	aday
蕆	admy
蕜	ahdn
薉	ahdy
薗	alfy
薽	asfy
藇	avgw
藥	arxs
蘴	amdu
虀	ayhg
虁	autt
虊	ayxs
虋	avmv
酀	akub
鞉	afqi
鞿	afxy
韈	afay
韮	ahdg
鷰	akuo
鸏	apfo
鹲	apfg
鞻	aflv
蔞	alvf
藪	alvt
斲	anfr
蔻	apfc
蘒	attx
虌	aumx
蕭	avfj
虀	aydg
薺	ayjf
菚	aaar
匞	aad
蘛	aade
藄	aadi
茙	aadr
蘜	aafo
菣	aahc
茝	aahh
茞	aahh
藍	aahl
藖	aahm
虦	aahm
蕥	aahy
剗	aajh
蓳	aakg
蓲	aakk
盞	aalf
蘳	aamf
蘣	aamg
蒆	aamv
茿	aamy
葉	aans
苉	aaqb
蔕	aaqh
戔	aar
蘙	aatn
芅	aau
苆	aavb
匶	aawv
莁	aaww
藂	abci
菆	abcu
蘟	aben
芓	abf
蔯	abgi
卭	abh
匩	abhg
藬	abkm
蕯	abtg
蓀	abti
薩	abug
蘵	abuj
匜	abv
蔭	abwc
蒢	abwt
匥	acak
芧	acbj
蓩	acbl
蕷	acbm
鶜	acbo
葇	acbs
蔘	acce
蓪	acep
葈	acks
荾	acwt
芆	acyu
蔵	adat
苃	adcu
弎	add
藞	addd
萇	adeu
莾	adfa
莀	adfe
荂	adfn
葴	adgt
蒧	adht
蘴	adhu
蔧	adhv
韮	adjg
菴	adjn
蕜	adjn
鄀	adkb
蠚	adkj
匲	adkk
逽	adkp
荋	admj
蕆	admt
項	admy
荿	adnt
荙	adpu
蒝	adri
藶	adth
芖	adu
蕼	advh
朞	adwe
卙	adwf
菶	adwh
剘	adwj
萶	adwj
蜝	adwj
蟴	adwj
惎	adwn
夦	adwq
棊	adws
尠	adwt
匧	adww
歁	adww
莢	adww
諅	adwy
葢	adyl
荗	adyt
萉	aecb
萾	aecl
薍	aecn
蕦	aedm
萠	aeef
薶	aeef
萲	aefc
藸	aefj
莇	aegl
苚	aej
﨟	aejn
莻	aekx
荕	aelb
蕣	aeph
薆	aept
蓫	aepu
葋	aeqk
蘨	aeri
葄	aetf
蔿	aeto
虅	aeuc
蕂	aeul
蓞	aevf
蒵	aexd
韄	afac
鞾	afaf
韊	afai
鞳	afak
蕡	afam
靾	afan
韉	afao
鞢	afas
韈	afat
蓋	afcl
靫	afcy
弍	afd
蘎	afec
鞵	afed
靻	afeg
鞖	afev
鞱	afev
靸	afey
蕓	affc
茥	afff
靯	affg
靬	affh
鞊	affk
韇	affm
韃	affp
蕘	affq
韁	afgg
靰	afgq
鞕	afgq
靺	afgs
鞆	afgw
鞁	afhc
鞐	afhh
蒖	afhw
鞺	afif
鞜	afij
鞩	afij
鞝	afik
鞉	afiq
苿	afiu
莍	afiy
芉	afj
鞸	afjf
鞮	afjh
鞰	afjl
鞨	afjn
韅	afjo
薣	afkc
鞙	afke
鞓	afkg
蘦	afkk
虂	afkk
鞼	afkm
薳	afkp
鞻	afkv
鞇	afld
匵	aflm
藚	aflm
萳	afmf
貳	afmi
靹	afmw
芌	afnb
薵	afnf
靵	afnf
鞚	afpa
葧	afpl
鞄	afqn
荺	afqu
靮	afqy
韂	afqy
鞞	afrf
鞡	afru
靪	afsh
韆	afsp
甛	aftd
鞽	aftk
鞦	afto
荖	aftx
鞂	afty
蕔	afuc
靽	afuf
鞧	afug
鞛	afuk
薘	afup
蓻	afuy
鞎	afve
鞀	afvk
鞬	afvp
靭	afvy
靱	afvy
鞥	afwa
蕶	afwc
藝	afwc
薔	afwk
鞈	afwk
靲	afwn
爇	afwo
蓺	afwy
鞃	afxc
靷	afxh
靿	afxl
鞿	afxt
鞟	afyb
鞹	afyb
蘾	afye
韀	afyo
華	agaf
茾	agaj
荊	agaj
鷨	agao
邼	agbh
萅	agbj
芚	agbn
荎	agcf
菿	agcj
弌	agd
菾	agdn
蒪	agef
	aghg
卄	aghh
芐	aghu
芣	agiu
蓴	agjf
荁	agjg
菄	agji
莄	agjq
菫	agkg
蒚	agkh
蘁	agkk
葍	agkl
藾	agkm
虉	agko
藗	agkp
荳	agku
薑	aglg
萰	agli
劻	agln
茦	agmi
蕀	agmi
莿	agmj
蓸	agmj
蓛	agmt
蔶	agmu
苪	agmw
黃	agmw
匸	agn
瓨	agnn
薞	agqe
塟	agqf
茢	agqj
薚	agqr
蔜	agqt
莖	agva
萐	agvh
葘	agvl
葝	agvl
蕐	agwh
薾	agwq
匤	agyi
蔖	ahag
萛	ahaj
蘆	ahal
萀	aham
藘	ahan
繤	ahdi
薉	ahdt
蕋	ahhh
煕	ahho
蘃	ahhs
匷	ahhy
蘋	ahim
荹	ahir
茮	ahiu
賾	ahkm
頤	ahkm
巸	ahkn
媐	ahkv
蓾	ahlo
孯	ahnb
臤	ahnc
硻	ahnd
腎	ahne
堅	ahnf
朢	ahng
緊	ahni
蜸	ahnj
臨	ahnk
監	ahnl
盬	ahnl
鹽	ahnl
賢	ahnm
贒	ahnm
頣	ahnm
薡	ahnn
覧	ahnq
覽	ahnq
鋻	ahnq
鍳	ahnq
鑒	ahnq
掔	ahnr
擥	ahnr
竪	ahnu
豎	ahnu
婜	ahnv
臥	ahnw
譼	ahny
蔝	ahou
莧	ahqb
薒	ahqo
萈	ahqy
鴉	ahto
藈	ahwd
蘫	aial
菃	aian
葓	aiaw
菭	aick
莦	aief
萷	aiej
蔆	aift
蔳	aige
蔋	aihc
蔢	aihv
蕰	aijl
蘯	aijl
蕩	aijr
蕅	aijy
薀	aill
莈	aimc
莐	aipq
茪	aiqb
萢	aiqn
萡	airf
薸	aisi
藫	aisj
莯	aisu
萿	aitd
蓱	aiua
蓡	aivc
薓	aivc
葏	aivh
菬	aivk
蒅	aivs
薻	aivs
虃	aiwg
蕍	aiwj
蒤	aiwt
蒞	aiwu
匯	aiwy
薃	aiyk
蓅	aiyq
蓽	ajaf
鄚	ajdb
驀	ajdc
蟇	ajdj
謩	ajdy
荲	ajff
蒔	ajff
皵	ajhc
萺	ajhf
剒	ajjh
蕌	ajjj
蒀	ajlf
躉	ajmh
蠆	ajmj
勱	ajml
邁	ajmp
萬	ajmy
逪	ajpd
茰	ajqu
斮	ajrh
菒	ajsu
菓	ajsu
葃	ajtf
虄	ajtg
匽	ajvd
鶠	ajvo
鵲	ajwo
菎	ajxx
戓	akd
艱	akfe
菋	akfi
囏	akfk
戁	akfn
歎	akfw
臡	akfw
尀	akfy
難	akfy
戜	akgd
茣	akgd
彧	akge
懃	akgn
覲	akgq
斳	akgr
藪	akgt
蔞	akgv
歏	akgw
蕗	akhk
匱	akhm
蕢	akhm
莡	akhu
鄿	akkb
酄	akkb
敺	akkc
毆	akkc
匰	akkf
蕇	akkf
剾	akkj
飌	akkj
區	akkk
虈	akkk
勸	akkl
顴	akkm
甌	akkn
蕚	akkn
鷗	akko
鸛	akko
觀	akkq
蘄	akkr
歐	akkw
歡	akkw
雚	akky
莂	aklj
蒷	akmu
荶	akwn
蓶	akwy
蔮	alag
艻	alb
蘻	albi
藣	alcx
蘮	aldj
薗	alfe
蓒	alfj
巭	alfw
葨	alge
莗	alj
莮	allb
蘲	allf
虆	alli
藟	alll
蘽	alls
蕒	almu
薎	alpa
鄸	alpb
蘉	alpc
顭	alpm
夢	alpq
蓮	alpu
薥	alqj
蔪	alrj
蔨	alub
匭	alvv
蒕	alwl
莔	alwm
鶓	alwo
苬	alwu
蔂	alxi
蘿	alxy
藅	alyj
蕽	amae
芁	amb
鶧	amdo
蓇	amef
苖	amf
巬	amfw
繭	amhj
芇	amhj
顢	amhm
荝	amjj
萴	amjj
蘡	ammv
萵	amnk
薖	amnp
慐	amnu
葻	amtj
貢	amu
貣	amu
菵	amun
斢	amwf
黊	amwf
黈	amwg
黇	amwk
黅	amwn
鷬	amwo
黆	amwq
萞	amwx
聓	amyb
鞏	amyf
芃	amyu
藯	anfn
戼	angn
匨	anhf
莊	anhf
葿	anhf
蔣	anhf
葦	anhh
蘠	anhk
苢	anhn
蕸	anhp
荍	anht
螶	anjj
蘗	anks
勚	anml
勩	anml
貰	anmu
乬	annb
巪	annb
蘂	anns
迣	anpv
枼	ansu
荱	antn
苾	antr
芵	anwu
藋	anwy
苨	anxb
蘹	anye
戉	anyt
薠	aodm
蘱	aodm
蕿	aoec
薱	aogf
蔊	aojf
藀	aooo
菼	aoou
蒾	aopu
炗	aou
苂	aou
茡	apbf
藔	apdi
萓	apeg
蒄	apff
萗	apfi
藆	apfr
蔲	apft
荢	apgf
鹲	apgg
萣	apgh
薲	apgm
藼	apgn
氋	apgn
鸏	apgo
蔩	apgw
蓂	apju
葷	aplj
藌	apnj
蔤	apnm
薴	apns
蒬	apqy
蒏	apsg
苧	apsj
荌	apvf
藛	apvo
葖	apwd
	apwl
茓	apwu
藭	apwx
蒮	apwy
荈	aqah
鬵	aqah
朁	aqaj
蠶	aqaj
兓	aqaq
茋	aqay
茒	aqbj
葾	aqbn
葼	aqbt
蒭	aqbt
芶	aqcu
莃	aqdh
薝	aqdy
蔛	aqef
薢	aqeh
葪	aqej
菳	aqf
蔔	aqgl
苅	aqjj
驚	aqkc
蟼	aqkj
葂	aqkl
憼	aqkn
莬	aqkq
藑	aqmt
萯	aqmu
蘚	aqod
薊	aqoj
蘇	aqot
炁	aqou
帶	aqph
慸	aqpn
遰	aqpp
茤	aqqu
匢	aqre
匫	aqrj
茐	aqry
蔱	aqsc
莥	aqtf
蕕	aqtg
蕏	aqtj
芕	aqu
兂	aqv
旡	aqv
蕵	aqwe
鴄	aqwo
鴎	aqwo
鴱	aqwo
匛	aqyi
藰	aqyj
蒥	aqyl
萚	arch
苽	arcy
蓏	arcy
蘤	areo
苩	arf
荴	arfw
茊	argf
葟	argf
蓵	argh
茩	argk
蒱	argy
薬	aris
莏	arit
葲	ariu
蘀	arlf
蕪	arlo
菗	armf
蒛	armw
芞	arnb
菦	arpu
蒐	arqc
菢	arqn
菂	arqy
藠	arrr
葀	artd
菈	aruf
蒑	arvc
萔	arvk
苵	arwu
蓷	arwy
薂	aryt
藲	asak
荰	asff
蓕	asff
蔈	asfi
薽	asfn
莤	asgf
蓜	asgn
艼	asj
莕	askf
萙	aspq
菻	assu
葽	asvf
藮	aswo
萊	asww
蒁	asyp
殹	atdc
醫	atdg
鹥	atdg
瞖	atdh
莑	atdh
繄	atdi
蕎	atdk
贀	atdm
悘	atdn
鷖	atdo
黳	atdo
芺	atdu
嫛	atdv
毉	atdw
瑿	atdy
薙	atdy
蒰	atec
蒩	ateg
蓗	atfh
芼	atfn
薐	atft
苼	atgf
菙	atgf
蘍	atgl
薫	atgo
匴	atha
苲	athf
蒠	athn
莚	athp
蕱	atie
葕	atih
萫	atjf
藒	atjn
茖	atkf
萂	atkf
莵	atky
萭	atky
蔥	atln
薁	atmd
蘈	atmm
藢	atmt
萩	atou
蘒	atqn
蘓	atqo
蔾	atqs
菞	atqt
蓹	atrb
薭	atrf
蘌	atri
蘒	attg
蕧	attt
萪	atuf
苸	atuh
蕛	atut
苳	atuu
蘶	atvc
葎	atvh
萟	atvy
蓯	atwh
蒣	atwt
藊	atya
荓	auaj
蓘	auce
萒	aucq
蒫	auda
菤	audb
藙	auec
蘢	aued
蕑	auef
葥	auej
苙	auf
菛	auf
荘	auff
蓤	auft
蘭	augi
蓔	augo
葁	augv
虁	auht
萻	aujf
蕫	aujf
蕳	aujf
蔁	aujj
蔀	aukb
酀	aukb
蔉	auke
蔄	aukf
鷰	auko
莌	aukq
嬊	aukv
蔐	aumd
蔏	aumk
藡	aump
虌	aumv
蕄	aunu
蒟	auqk
薋	auqm
藱	aurc
藽	ausq
菨	auvf
蔅	auvf
藺	auwy
苝	auxb
蕁	avaf
芀	avb
莭	avcb
蔇	avcq
茟	avfh
蓃	avhc
蕭	avhh
藎	avhl
菉	aviu
蕠	avki
蒘	avkr
菑	avlf
菷	avph
萖	avqb
蕮	avqo
莙	avtk
蔒	avto
芛	avtr
茘	avvv
葌	avvv
袃	avye
荵	avyn
茷	awar
葰	awct
葮	awdc
芿	aweb
芢	awff
虋	awfv
藇	awfw
菕	awga
葊	awga
蘥	awga
蒨	awge
剳	awgj
匬	awgj
萮	awgj
薈	awgj
匼	awgk
荅	awgk
蘞	awgt
匳	awgw
薟	awgw
蘝	awgw
蓚	awhe
蓨	awhe
蓧	awhs
苶	awiu
蛬	awju
藵	awke
茽	awkh
輂	awlj
苮	awmj
葔	awnd
蒒	awnh
蘬	awnh
躠	awnh
糵	awno
拲	awrj
茠	awsu
莋	awtf
鷋	awto
葠	awvc
葐	awvl
蔦	awvo
鳶	awvo
棻	awvs
莝	awwf
葅	awwg
鹀	awwg
鵐	awwo
遳	awwp
覡	awwq
蓌	awwt
芲	awxb
蕟	awxc
蒊	awxx
蒦	awyc
隿	awyg
莟	awyk
蒼	awyk
菍	awyn
舊	awyv
葒	axaf
虇	axay
葞	axbf
苰	axcu
藧	axec
蒃	axeu
蘏	axfm
葤	axfu
蒓	axgn
苺	axgu
苐	axht
蘰	axjc
茀	axjj
藴	axjl
蔃	axkj
苭	axlb
蘊	axll
蒳	axmw
蕝	axqc
葯	axqy
藥	axrs
薌	axtb
薿	axth
蘔	axtm
蘕	axtp
蔠	axtu
蒻	axuu
蒶	axwv
蕬	axxi
茲	axxu
虊	axys
蓆	ayah
蘺	ayby
蓭	aydn
蘐	ayec
藷	ayfj
萕	ayjf
藹	ayjn
蘘	ayke
苀	aymb
蔎	aymc
藳	aymt
匟	aymv
藃	aymw
萹	ayna
蔰	aync
菺	ayne
薼	aynf
莣	aynn
薦	ayno
藨	ayno
蘪	ayno
荄	aynw
蔍	aynx
薧	aypx
菧	ayqy
藦	aysr
蔴	ayss
葹	aytb
蔙	ayth
蒍	ayto
芠	ayu
薕	ayuo
蓈	ayvb
蓢	ayve
薺	ayvf
虀	ayvg
蓎	ayvk
菮	ayvw
蓙	aywf
鄓	ahnl
龨	awyd
龩	aafr
龷	aghg
龿	awff
鿀	aatg
鿊	aihf
鿒	admu
鿓	admu
鿓	adhw
鿦	amdt
乸	bxyy
聀	bay
聁	bwvt
聈	bxlt
聎	bqiy
阞	blt
陫	bhdd
隇	bdgy
孲	bgfg
隮	byjg
陿	badw
隁	bajv
聝	bakg
聀	bat
孨	bbbf
聶	bbbf
孴	bbbj
顳	bbbm
孖	bbg
聑	bbg
聉	bbmh
阤	bbn
郰	bcbh
埾	bcff
孡	bckg
焣	bcou
阭	bcqn
棸	bcsu
陖	bcwt
隓	bdaa
墮	bdaf
嶞	bdam
隨	bdap
阨	bdbn
耾	bdcy
陏	bdeg
陙	bdfe
陓	bdfn
隇	bdgt
陫	bdjd
陾	bdmd
聏	bdmj
陑	bdmj
陭	bdsk
陦	bdtf
陝	bdty
聗	bdww
陜	bdww
隱	bean
檃	beas
櫽	beas
隠	bevn
隫	bfam
耺	bfcy
阹	bfcy
隭	bfdj
隢	bffq
聐	bfkg
聴	bfln
隯	bfnf
陼	bftj
陸	bfwf
陚	bgah
孒	bgd
聙	bgeg
陠	bgey
聽	bgfn
孲	bghg
聇	bghg
阷	bghg
阫	bgiy
陳	bgji
螴	bgjj
敶	bgjt
陃	bgmw
隞	bgqt
陘	bgva
隬	bgwq
隵	bhaa
芔	bhbh
阯	bhg
旹	bhgj
妛	bhgv
騭	bhic
顄	bibm
陗	bieg
脀	bige
巹	bign
烝	bigo
氶	bii
隚	bipf
聎	biqn
隲	bitc
阥	biy
隄	bjgh
陽	bjgr
刵	bjh
凾	bkcb
焏	bkco
叾	bkf
聖	bkgf
聵	bkhm
隤	bkhm
隕	bkmy
塦	blff
陣	blh
阞	bln
耼	bmfg
隑	bmgu
孾	bmmv
糶	bmoy
欪	bmqw
孭	bmy
阠	bnfh
隦	bnku
巜	bnn
耴	bnn
	bnn
孞	bnu
恥	bny
隣	boqh
隣	boqh
阦	boy
褧	boye
孮	bpfi
聢	bpgh
聹	bpns
迆	bpv
聜	bpwa
聺	bpwi
阺	bqay
陒	bqdb
聸	bqdy
陥	bqhj
陱	bqoy
陊	bqqy
聦	bqrn
陎	briy
聭	brqc
聛	brtf
陻	bsfg
娿	bskv
陞	btaf
阩	btah
陹	btaj
艸	btbh
茻	btbh
陁	btbn
聅	btdy
聕	btfk
毦	btfn
隀	btgf
聥	btky
聰	btln
隩	btmd
阣	btnn
孼	btwb
蠥	btwj
雟	btwk
糱	btwo
櫱	btws
辥	btwu
孫	btxi
愻	btxn
遜	btxp
聠	buah
職	buaj
隴	bued
墜	buef
鐆	bueq
隊	buey
阧	bufh
隌	bujg
隡	butg
隒	buvo
隉	bvag
孻	bvhl
隟	bvjs
聣	bvqn
聡	bwcn
聬	bwcn
隂	bwdy
聄	bwet
際	bwfi
陯	bwga
聧	bwgd
隃	bwgj
隥	bwgu
険	bwgw
險	bwgw
隖	bwno
﨩	bwvm
聁	bwvn
隝	bwvo
鵈	bwvo
阾	bwyc
陰	bwyc
陮	bwyg
耹	bwyn
墬	bxef
聈	bxln
聨	bxxa
聫	bxxd
聯	bxxg
阰	bxxn
聮	bxxo
階	bxxr
埅	byff
卪	byi
阬	bymn
聤	byps
隮	byvf
阸	bynn
鿢	bbwk
鿣	bbdq
鿤	bbsk
鿧	btgq
勈	celt
瓵	ckgy
駣	cqiy
駵	cgjn
騀	ctry
騑	chdd
驑	cgjl
驠	cako
驌	cvfj
駴	caah
駥	cadt
騏	cadw
驧	cafo
驊	cagf
馵	caj
騲	cajh
騹	cakg
驅	cakk
驩	caky
駏	cang
駆	caqy
驠	cauo
鴘	cawo
驟	cbci
預	cbdm
駬	cbg
馳	cbn
矝	cbtc
矡	cbtc
騖	cbtc
奦	cbtd
矟	cbte
堥	cbtf
鞪	cbtf
劀	cbtj
暓	cbtj
矠	cbtj
矞	cbtk
務	cbtl
嵍	cbtm
愗	cbtn
氄	cbtn
熃	cbto
鶔	cbto
鶩	cbto
鷸	cbto
遹	cbtp
楘	cbts
敄	cbtt
驈	ccbk
騥	ccbs
叕	cccc
敠	cccc
叄	cccd
參	ccce
驂	ccce
亝	cccf
骉	cccf
絫	ccci
剟	cccj
剼	cccj
顙	cccm
叅	cccn
毲	cccn
毿	cccn
鵽	ccco
逫	cccp
遪	cccp
敪	ccct
厽	cccu
驫	cccu
欼	cccw
歠	cccw
騒	ccjy
駘	cckg
斚	ccpf
馻	ccqn
騃	cctd
駿	ccwt
厸	ccy
馭	ccy
騳	ccy
騷	ccyj
騞	cdhd
騑	cdjd
奙	cdjn
軬	cdlj
貵	cdmu
駹	cdne
駀	cdnn
騻	cdqq
騵	cdri
騎	cdsk
馱	cdy
駄	cdyy
駔	cegg
勈	celn
騱	cexd
螚	cexj
態	cexn
熋	cexo
馺	ceyy
驖	cfag
馶	cfcy
頚	cfdm
驍	cffq
馯	cfh
驝	cfps
驦	cfsh
骦	cfsh
驑	cgal
駵	cgan
駤	cgcf
馬	cghy
駓	cgig
駷	cgki
馷	cgmh
驪	cgmx
駍	cguh
驉	chag
驢	chal
駊	chcy
覌	chqn
騨	cijf
駣	ciqn
駫	ciqn
厼	ciu
驆	cjaf
駻	cjfh
馹	cjg
驲	cjg
騠	cjgh
騴	cjpv
騔	cjqn
騍	cjsy
騉	cjxx
駽	ckeg
瓵	ckgn
馴	ckh
馽	ckhj
刣	ckjh
驒	ckkf
乨	cknn
駛	ckqy
枲	cksu
辝	ckuh
巼	ckxb
駰	cldy
骃	cldy
驛	clff
駟	clg
騦	clny
圅	cluf
騾	clxi
駚	cmdy
騆	cmfk
駎	cmg
駧	cmgk
騁	cmgn
岊	cmj
駉	cmkg
騧	cmnk
颿	cmtj
貟	cmu
贠	cmu
驨	cmwk
驏	cnbb
騢	cnhc
駶	cnnk
騽	cnrg
駜	cntt
騛	cnuh
駃	cnwy
	cny
駅	cnyy
驜	cogw
驎	coqh
騌	cpfi
骔	cpfi
驞	cpgm
遤	cpi
馾	cpqn
駝	cpxn
騣	cqbt
騶	cqbt
駨	cqjg
駒	cqkg
駁	cqqy
騊	cqrm
騘	cqrn
駠	cqtb
騮	cqyl
馰	cqyy
駈	crgg
騜	crgg
馸	crh
劺	crhl
鴾	crho
駯	criy
騡	criy
騩	crqc
驃	csfi
驔	csjh
騕	csvg
騋	csww
馲	ctan
駞	ctbn
驕	ctdk
逘	ctdp
欸	ctdw
騈	ctff
駪	ctfq
駳	cthp
駱	ctkg
驄	ctln
騀	ctrt
騬	ctux
駇	cty
駢	cuah
驣	cudc
騚	cuej
騂	cuh
骍	cuh
騿	cujh
駾	cukq
驓	culj
騯	cupy
駮	cuqy
驥	cuxw
騝	cvfp
騪	cvhc
驌	cvhh
骕	cvij
騄	cviy
駋	cvkg
駸	cvpc
骎	cvpc
駗	cwet
騇	cwfk
駙	cwfy
騤	cwgd
骙	cwgd
駩	cwgg
騟	cwgj
験	cwgw
驗	cwgw
鵕	cwto
夋	cwtu
駼	cwty
鳮	cwvo
驋	cwxc
駖	cwyc
騅	cwyg
騐	cwyn
驐	cybt
駐	cygg
驤	cyke
驙	cylg
騙	cyna
騸	cynn
馿	cynt
駭	cynw
騼	cynx
駲	cyth
駺	cyve
馼	cyy
龭	claw
龮	cnlw
龴	cny
劯	dlt
勀	dqlt
勊	dqle
厐	ddxe
厜	dtfg
厞	dhdd
厯	dssy
奯	dhdy
烕	dgoy
瓳	dgny
瓺	dgny
砏	dwvt
砙	dgny
砪	dxyy
硾	dtfg
碊	daay
磩	ddhy
磯	dxxy
礒	dugy
礖	dvgw
礣	daly
礫	drxs
耭	dixy
髣	deyr
靥	dddd
奫	dijg
耬	dilv
礷	daal
碊	daat
磡	dadl
碪	dadn
毻	daen
遀	daep
礚	dafl
矼	dag
礡	dagf
礛	dahl
礥	dahm
厊	daht
碏	dajg
勵	dajl
礍	dajn
厲	dajy
厪	dakg
奩	dakk
礶	daky
礣	dalt
碤	damd
碽	damy
奆	danf
硴	dawx
硔	dawy
頋	dbdm
矷	dbg
硁	dcag
夿	dcb
磣	dcce
硧	dceh
唘	dckf
盋	dclf
翃	dcng
礟	dcqq
厷	dcu
厺	dcu
犮	dcu
礮	dcuq
碼	dcy
礪	dday
砈	ddbn
飆	dddj
猋	dddu
磭	ddfe
砳	ddg
碶	ddhd
磩	ddht
厞	ddjd
奭	ddjj
硽	ddjn
黡	ddlo
奤	ddmd
碝	ddmd
碩	ddmy
厖	ddne
硥	ddne
磢	ddqq
碕	ddsk
礰	ddth
镽	ddui
硤	ddww
厐	ddxv
夶	ddy
鬕	dead
戫	deag
髰	dean
髸	deaw
鬗	deay
髢	debb
髶	debf
鬖	dece
髳	dect
髪	dedc
髮	dedc
鬌	dede
鬍	dede
髵	dedj
鬊	dedj
鬅	deee
奟	deef
鬚	deem
鬐	defj
髨	defq
鬒	defw
砠	degg
髬	degg
鬎	degj
髩	degn
砽	deh
髲	dehc
髾	deie
髿	deit
鬘	dejc
鬄	dejr
鬛	deln
髷	dema
髠	demb
鬞	deme
髥	demf
戞	depa
鄾	depb
迶	depd
鬢	depm
髧	depq
鬡	deps
憂	dept
鬇	deqh
髱	deqn
鬉	deqt
磘	derm
鬂	derw
鬆	desc
髤	desu
髺	detd
髼	deth
鬁	detj
鬔	detp
長	deu
龓	deud
鬜	deue
鬋	deuj
鬙	deuj
鬝	deuj
鬑	deuo
鬀	deut
髽	dewf
鬠	dewj
鶘	dewo
鶦	dewo
磎	dexd
髴	dexj
髣	deyb
鬤	deye
砐	deyy
硺	deyy
逩	dfap
夽	dfcu
圧	dfd
礝	dfdj
鄏	dfeb
脣	dfee
敐	dfet
圶	dff
夳	dff
厓	dffd
磽	dffq
厧	dfhw
磌	dfhw
夲	dfj
厈	dfk
硈	dfkg
礂	dfkk
礌	dflg
郀	dfnb
綔	dfni
鴮	dfno
硳	dfoy
礵	dfsh
硣	dftb
奲	dftf
硏	dftf
硓	dftx
碐	dfwt
砆	dfwy
礭	dfwy
硦	dgah
碔	dgah
揅	dgar
厔	dgcf
磗	dgef
碃	dgeg
镸	dghy
磚	dgjf
觱	dgke
顑	dgkm
磧	dgmy
瓳	dgnn
瓺	dgnn
砙	dgnn
烕	dgot
矹	dgqn
厫	dgqt
磝	dgqt
砞	dgsy
丆	dgt
	dgt
硜	dgva
镾	dgwq
砡	dgyy
艷	dhdc
剨	dhdj
奡	dhdj
豓	dhdl
豔	dhdl
熭	dhdo
奯	dhdt
豒	dhdt
豐	dhdu
砋	dhg
夒	dhht
顣	dhim
慼	dhin
磠	dhlo
硵	dhlq
碵	dhmy
硯	dhqn
兏	dhqv
齧	dhvb
觢	dhve
洯	dhvi
絜	dhvi
蛪	dhvj
栔	dhvs
耯	diac
耤	diaj
耟	dian
耛	dick
頛	didm
耰	didt
耝	dieg
耡	diel
耫	digm
耚	dihc
耬	dikv
	dilc
耞	dilk
	dilx
厰	dimt
耮	diol
礑	dipl
礃	dipr
硄	diqn
耓	dish
奫	dith
夵	diu
耣	diwa
耭	dixt
砅	diy
耲	diye
奜	djdd
猆	djdd
餥	djde
剕	djdj
皕	djdj
輩	djdl
靟	djdn
棐	djds
婓	djdv
魘	djec
厭	djed
靨	djed
饜	djee
壓	djef
奛	djef
厴	djel
懕	djen
黶	djeo
擪	djer
檿	djes
嬮	djev
碮	djgh
碭	djgr
矵	djh
夰	djj
剦	djnj
鵪	djno
厬	djtk
礘	djxo
夻	dkf
磾	dkkf
礹	dkkt
磒	dkmy
厛	dkrk
厑	dkxv
礋	dlff
碨	dlge
硨	dlh
厙	dlk
靣	dlkf
硘	dlkg
礧	dlll
劯	dln
硱	dlsy
碅	dlty
磥	dlxi
砓	dmcy
硸	dmdf
顨	dmdj
磞	dmee
磆	dmeg
奝	dmfk
磑	dmgu
耎	dmjd
耏	dmje
蠠	dmjj
厠	dmjk
勔	dmjl
靧	dmjm
靤	dmjn
鴯	dmjo
靦	dmjq
碢	dmnk
硙	dmnn
碋	dmsk
碸	dmtj
頁	dmu
碙	dmum
磮	dmwa
硶	dmwn
磪	dmwy
砃	dmyg
尷	dnal
乭	dnb
镼	dnbm
尨	dnee
尮	dnes
尪	dngd
碬	dnhc
碿	dnie
尵	dnkm
礔	dnku
尳	dnme
郕	dnnb
尯	dnqb
磖	dnrg
尰	dntf
怘	dnu
尲	dnuo
磟	dnwe
砄	dnwy
礏	dogw
礯	dooi
磱	dool
硡	dpdc
磍	dpdk
碂	dpfi
礗	dpgm
迖	dpi
碦	dptk
硿	dpwa
確	dpwy
碈	dqaj
厎	dqay
奃	dqay
硊	dqdb
兣	dqdf
兡	dqdj
尅	dqfi
兙	dqfk
碒	dqg
剋	dqjk
勀	dqln
勊	dqlv
砲	dqnn
鷞	dqqo
奓	dqqu
奅	dqtb
兛	dqtf
兞	dqtn
碀	dqvh
兝	dqwv
磂	dqyl
镹	dqyy
碷	drfh
砶	drg
磃	drhm
厡	drii
厵	drii
願	drim
硃	driy
厒	drmk
磈	drqc
礩	drrm
磤	drvc
镻	drwy
礉	dryt
磦	dsfi
砵	dsgg
矴	dsh
磹	dsjh
攲	dskc
敧	dskc
砢	dskg
鵸	dsko
歴	dssh
礎	dssh
暦	dssj
厯	dssn
碄	dssy
硹	dswc
矺	dtan
厇	dtav
幚	dtbh
砤	dtbn
硚	dtdj
礄	dtdk
镺	dtdy
硞	dtfk
礸	dtfm
厜	dtgf
硾	dtgf
厏	dthf
硟	dthp
邫	dtkc
磇	dtlx
礇	dtmd
矻	dtnn
磻	dtol
磿	dttd
歷	dtth
厤	dtti
曆	dttj
磫	dtwh
硑	duah
蹷	dubh
蟨	dubj
憠	dubn
鷢	dubo
磀	dubp
橜	dubs
礢	dude
羍	dudj
磰	dudk
礲	dued
龎	dued
礀	dueg
礈	duep
礒	dugt
眘	duhf
昚	dujf
磵	dujg
尞	duji
鷯	dujo
遼	dujp
厗	duk
磳	dulj
磸	dusd
冭	duu
磏	duvo
礠	duxn
硍	dvey
砕	dvfh
硉	dvfh
磶	dvqo
碯	dvtq
碫	dwdc
磜	dwfi
礖	dwfw
碖	dwga
硂	dwgg
硆	dwgk
厱	dwgw
礆	dwgw
	dwi
砎	dwjh
惷	dwjn
磓	dwnp
硢	dwty
憃	dwvn
砏	dwvn
鳫	dwvo
鴣	dwvo
郟	dwwb
夾	dwwi
硲	dwwk
贋	dwwm
贗	dwwm
頰	dwwm
鴈	dwwo
鵊	dwwo
砱	dwyc
奞	dwyf
奪	dwyf
奮	dwyl
砛	dwyn
磼	dwys
	dxgd
砪	dxgu
礫	dxrs
礙	dxth
磯	dxxt
詟	dxyf
礦	dyaw
砿	dycy
砫	dygg
砯	dyiy
盇	dylf
碻	dymk
砊	dymn
砨	dynn
奒	dynw
硋	dynw
硛	dyoy
迏	dypi
碠	dyps
礳	dysd
硠	dyve
磄	dyvk
砇	dyy
絕	dggg
鿎	ddpy
鿬	dlg
朌	ewvt
朓	eqiy
胟	exyy
脢	etxy
腄	etfg
臓	eady
臙	eako
臟	eady
辸	epe
貗	eelv
膢	elvg
臍	eyjg
臓	eadt
臟	eadt
膩	eafm
腜	eafs
臔	eahm
臈	eajn
膒	eakk
朠	eamd
朑	eann
脦	eany
臙	eauo
臒	eawc
膵	eayf
鵩	ebco
朏	ebmh
胐	ebmh
肔	ebn
嗠	ebtk
腬	ecbs
腏	eccc
夃	eci
蜰	ecju
亂	ecmn
覶	ecmq
辭	ecmu
豝	ecn
朘	ecwt
脧	ecwt
肞	ecyy
膸	edap
胈	edcy
脹	edey
呄	edf
脤	edfe
脜	edhg
肨	edhh
腝	edmd
澃	edmi
胹	edmj
盨	edml
媭	edmv
嬃	edmv
頾	edmx
須	edmy
肬	ednn
脄	edoy
豲	edri
膫	edui
脥	edww
肰	edy
貙	eeak
貓	eeal
貛	eeay
貀	eebm
貕	eeed
朤	eeee
豻	eefh
脟	eefy
豠	eegg
豾	eegg
貆	eegg
貜	eehc
貋	eejf
貍	eejf
蠫	eejj
貚	eekf
貗	eekv
貒	eemj
豽	eemw
貑	eenc
遯	eepi
貁	eepw
豿	eeqk
貏	eerf
貃	eerg
貈	eete
貖	eeul
貇	eeve
墾	eevf
脮	eevg
貄	eevh
懇	eevn
貎	eevq
貐	eewj
鵬	eewo
膎	eexd
豯	eexd
豼	eexx
豩	eey
膹	efam
豮	efam
豶	efam
胠	efcy
臑	efdj
頱	efdm
胿	effg
膮	effq
脙	efiy
	efny
豷	efpu
豣	eftf
豬	eftj
鶢	efto
櫫	efts
寽	efu
膤	efvg
鶏	efwo
臛	efwy
豜	egah
豘	egbn
胵	egcf
脿	egey
豧	egey
脴	egik
肧	egiy
膞	egjf
刞	egjh
腖	egji
脨	egki
腷	egkl
脰	egku
脼	egmy
胓	eguh
脛	egva
脻	egvh
鴡	egwo
膆	egxi
臄	ehae
臚	ehal
臞	ehhy
丯	ehk
胋	ehkg
覓	ehqb
辵	ehu
頿	ehxm
脳	eiqb
朓	eiqn
脁	eiqn
膌	eiwe
腸	ejgr
蟸	ejju
豱	ejlg
腢	ejmy
腂	ejsy
脵	ekgd
脭	ekgg
膢	ekgv
膭	ekhm
胑	ekwy
膕	elag
盁	elf
腲	elge
腘	elgy
脇	elll
臅	elqj
膃	elwl
膿	emae
豛	emcy
腨	emdj
胦	emdy
爯	emff
腗	emgj
腡	emnk
膼	emnp
朒	emww
膗	emwy
腒	endg
腛	engf
腵	enhc
豭	enhc
肊	enn
膠	enwe
胒	enxn
臎	enyf
朥	eool
腅	eooy
臗	epay
辤	epcu
迌	epd
腟	epgf
臏	epgm
腪	eplh
愛	epnt
辸	epv
朡	eqbt
脃	eqcn
脪	eqdh
豨	eqdh
膽	eqdy
胊	eqkg
豞	eqkg
脕	eqkq
褜	eqne
脗	eqrk
肳	eqrt
肑	eqyy
脈	erey
腯	erfh
胉	erg
肵	erh
脌	erhf
膴	erlo
颻	ermj
鷂	ermo
飖	ermq
胅	erwy
刴	esjh
胢	eskg
朶	esu
胮	etah
胣	etbn
膖	etdp
腁	etff
胻	etfh
臜	etfm
臢	etfm
膬	etfn
脡	etfp
甤	etgd
腄	etgf
腫	etgf
臐	etgo
脠	ethp
脷	etjh
膓	etjr
膍	etlx
爳	etnb
鄬	etnb
噕	etnk
肐	etnn
爲	etno
胏	etnt
膰	etol
腇	etvg
豵	etwh
脢	etxu
爫	etyt
膱	euaj
腃	eudb
騰	eudc
	eudg
幐	eudh
羘	eudh
膡	eudh
縢	eudi
螣	eudj
勝	eudl
賸	eudm
鰧	eudo
黱	eudo
榺	euds
謄	eudy
朧	eued
膶	eugg
朣	eujf
膧	eujf
腤	eujg
豴	eumd
腣	euph
膁	euvo
膉	euwl
豤	evey
肗	evg
膄	evhc
爭	evhj
臘	evln
肍	evn
腉	evqn
腦	evtq
鵎	evwo
肒	evyy
肕	evyy
腶	ewdc
肸	ewfh
胕	ewfy
腀	ewga
膾	ewgj
肹	ewgn
膯	ewgu
臉	ewgw
脫	ewkq
膇	ewnp
朌	ewvn
肦	ewvn
腳	ewwb
朎	ewyc
脽	ewyg
臇	ewym
肣	ewyn
腍	ewyn
膲	ewyo
谿	exdk
鷄	exdo
雞	exdy
腞	exey
胟	exgu
乿	exin
胇	exjh
膙	exkj
膷	extb
肶	exxn
朜	eybg
脝	eybh
豖	eyi
剢	eyjh
豟	eynn
臕	eyno
豥	eynw
膔	eynx
朖	eyve
臍	eyvf
膅	eyvk
脺	eywf
膟	eyxf
胘	eyxy
﨤	eyyp
栻	eeee
烒	eeee
肞	eyqy
刧	fcvt
劸	fflt
坋	fwvt
垇	fhng
垗	fqiy
埵	ftfg
堿	fdgy
塜	fpfe
墄	fdhy
壪	fyxx
攰	fcle
豰	fpfc
赲	fhle
趒	fhqi
逺	fnwp
遠	fkwp
雰	fwvr
雱	fyr
雿	fqiu
霥	fpfe
霵	fkby
靊	fmdu
韯	fahg
	fai
鼁	fcxf
鼃	ffxf
埡	fgfg
鼘	fkug
塿	flvg
壺	fpfg
鷇	fpgc
黿	fqxf
栞	ftfs
鼀	fwxf
霽	fyjf
韯	fadg
墈	fadl
	fae
卋	faf
鼖	fafc
雸	faff
墸	fafj
壒	fafl
墷	fagf
臷	fagf
壏	fahl
塻	fajd
蛓	faji
墐	fakg
塸	fakk
壦	faky
載	falk
霙	famd
翸	famn
賁	famu
墴	famw
歕	famw
胾	famw
烖	faoi
靀	fape
尭	faqb
墆	faqh
酨	fasg
枽	fasu
桒	fasu
塂	fawn
塨	fawn
埖	fawx
垬	fawy
塃	fayq
壭	fbj
凷	fbk
逇	fbpv
霳	fbtg
壣	fbxg
弆	fcaj
叝	fcbc
霿	fcbh
霱	fcbk
霧	fcbl
雺	fcbt
霚	fcbt
墋	fcce
頍	fcdm
叆	fcec
埇	fceh
刦	fcjh
朅	fcjn
坮	fckg
唟	fckx
攰	fclv
鼁	fcmv
迲	fcpi
攳	fcvf
刧	fcvn
叇	fcvp
刼	fcvy
鳷	fcwo
埈	fcwt
堶	fdae
坺	fdcy
雼	fdf
堐	fdff
坧	fdg
堿	fdgt
墄	fdht
靊	fdhu
壥	fdlf
堧	fdmd
顬	fdmm
頇	fdmy
墭	fdnl
垯	fdpy
塽	fdqq
埼	fdsk
垹	fdtb
壢	fdth
靂	fdth
埲	fdwh
堾	fdwj
埉	fdww
垺	febg
埓	fefy
坥	fegg
霢	fere
垜	fesy
埰	fesy
塪	fevg
霡	feyi
雭	feyu
壩	ffae
墳	ffam
邽	ffbh
邿	ffbh
霴	ffci
靅	ffcm
霒	ffcn
霕	ffcn
霼	ffco
靆	ffcp
靉	ffct
雲	ffcu
壖	ffdj
亖	fff
墵	fffc
垚	ffff
堼	ffff
壵	ffff
鞤	ffff
幇	fffh
幫	fffh
犎	fffh
顤	fffm
翹	fffn
遶	fffp
堯	fffq
墝	fffq
奊	ffgy
隷	ffii
刲	ffjh
墘	ffjn
郌	ffkc
壊	ffle
劸	ffln
鼃	ffmv
鄠	ffnb
壔	ffnf
霊	ffog
坃	ffqn
墶	ffup
墻	ffwk
堎	ffwt
麉	ffyx
坉	fgbn
埥	fgeg
埡	fghg
墕	fgho
雫	fghu
圷	fghy
塼	fgjf
埬	fgji
堛	fgkl
壃	fglg
堜	fgli
霋	fgvv
坘	fgxg
塐	fgxi
壉	fhae
趞	fhaj
壚	fhal
趪	fhaw
趉	fhbm
趌	fhfk
趬	fhfq
圵	fhg
垰	fhgh
趚	fhgi
趰	fhgq
趠	fhhj
趈	fhhk
埱	fhic
趙	fhie
趒	fhiq
埗	fhit
赻	fhit
趕	fhjf
趧	fhjh
趗	fhkh
趮	fhks
嗭	fhkx
塷	fhlo
赲	fhlv
趩	fhlw
赸	fhmk
趓	fhms
趐	fhnd
悳	fhnn
趘	fhnn
惪	fhnu
赽	fhnw
趯	fhny
趤	fhpd
赿	fhqa
趛	fhqd
趂	fhqi
垷	fhqn
趜	fhqo
趍	fhqq
趨	fhqt
赹	fhqu
赼	fhqw
趆	fhqy
趎	fhri
赾	fhrk
趃	fhrw
趏	fhtd
趫	fhtk
趲	fhtm
趀	fhtt
趇	fhud
﨣	fhuf
趥	fhug
趦	fhuk
趢	fhvi
趖	fhwf
顛	fhwm
赺	fhwn
趝	fhwn
趭	fhwo
鷏	fhwo
埧	fhwy
趡	fhwy
圤	fhy
霮	fian
霟	fiaw
靋	fidh
祘	fifi
霑	fihk
埫	fimk
霘	fimk
礼	finn
壋	fipl
霃	fipq
雿	fiqb
垗	fiqn
垙	fiqn
霂	fisu
孷	fitb
釐	fitf
犛	fith
漦	fiti
氂	fitn
剺	fitv
斄	fitw
霶	fiuy
垱	fivg
霗	fiwc
塉	fiwe
霐	fixc
皳	fiyc
霔	fiyg
盚	fiyl
慦	fiyn
壜	fjfc
坓	fjff
塒	fjff
垾	fjfh
亁	fjfn
冓	fjgf
斠	fjgf
顜	fjgm
覯	fjgq
場	fjgr
刌	fjh
汬	fjiu
	fjj
霷	fjjr
塭	fjlg
堣	fjmy
電	fjnb
韓	fjnh
乹	fjnn
堨	fjqn
堁	fjsy
刱	fjvw
幹	fjwf
螒	fjwj
鶾	fjwo
榦	fjws
倝	fjwy
雗	fjwy
堒	fjxx
丼	fjyi
郆	fkbh
霵	fkbt
頡	fkdm
埍	fkeg
遠	fkep
嚞	fkfk
塿	fkgv
墤	fkhm
壝	fkhp
龗	fkkd
喪	fkke
墠	fkkf
霝	fkkk
賷	fkkm
堮	fkkn
壧	fkkt
孁	fkkv
靈	fkkw
劼	fkln
霣	fkmu
塤	fkmy
翓	fkng
迼	fkpd
臺	fkpf
欯	fkqw
敼	fkuc
皷	fkuc
鼔	fkuc
鼚	fkue
壴	fkuf
尌	fkuf
鼞	fkuf
噽	fkug
鼘	fkuh
蟚	fkuj
鼜	fkuj
嚭	fkuk
囍	fkuk
鼛	fkuk
壾	fkun
憙	fkun
鼕	fkuu
鼟	fkuu
歖	fkuw
鴶	fkwo
霬	flaw
堌	fldg
墿	flff
靐	flfl
堽	flgh
夁	flld
協	flll
靁	flll
皾	flmc
覿	flmq
賣	flmu
畞	flqy
堺	flwj
霻	fmau
坄	fmcy
堓	fmdf
雵	fmdu
坱	fmdy
塴	fmee
霌	fmfk
塏	fmgu
圸	fmh
坰	fmkg
垇	fmmg
堝	fmnk
堸	fmtj
堈	fmum
遖	fmup
埛	fmwk
埁	fmwn
墔	fmwy
垻	fmy
魗	fnac
壽	fnaf
垊	fnan
翿	fnan
燾	fnao
逺	fnep
墛	fnff
霨	fnff
堩	fngg
韨	fnhc
壻	fnhe
堳	fnhg
覟	fnhq
夀	fnkf
壀	fnku
聲	fnmb
殸	fnmc
漀	fnmi
韾	fnmj
毊	fnmk
鏧	fnmq
撀	fnmr
圠	fnn
迃	fnpv
霫	fnrf
忈	fnu
塀	fnua
亐	fnv
頳	fodm
墣	fogy
赪	fohm
赬	fohm
覝	fohq
赨	fojy
赮	fonc
埮	fooy
赩	foqc
赥	foqw
灻	fou
赯	foyk
郣	fpbb
愂	fpbn
鵓	fpbo
鷇	fpdc
蠧	fpdj
槖	fpds
塚	fpey
垨	fpfy
嗀	fpgc
殼	fpgc
瑴	fpgc
皼	fpgc
瞉	fpgc
穀	fpgc
糓	fpgc
縠	fpgc
豰	fpgc
轂	fpgc
嗀	fpgc
塜	fpge
霥	fpge
壸	fpgg
塇	fpgg
壼	fpgg
埞	fpgh
螜	fpgj
靌	fpgm
亄	fpgn
愨	fpgn
鷧	fpgo
壺	fphg
塓	fpju
辻	fpk
迀	fpk
壷	fpkg
堚	fplh
疐	fplh
殻	fpmc
坈	fpmn
慤	fpmn
埦	fpqb
売	fpqb
坾	fpsh
垞	fpta
榖	fpgc
穀	fptc
垵	fpvg
埪	fpwa
堗	fpwd
塎	fpwk
靏	fpwo
堔	fpws
坹	fpwy
壱	fpxb
坁	fqan
圥	fqb
邧	fqbh
堫	fqbt
兘	fqck
垝	fqdb
頑	fqdm
埆	fqeh
坖	fqff
刓	fqjh
坸	fqkg
黿	fqmv
垉	fqnn
垑	fqqy
圽	fqrt
鋆	fquq
埳	fqvg
埩	fqvh
靎	fqwo
朮	fqyi
塯	fqyl
霤	fqyl
怷	fqyn
圴	fqyy
坬	frcy
坵	frgg
堭	frgg
墲	frlo
塊	frqc
墽	fryt
墂	fsfi
圢	fsh
鹴	fshg
鸘	fsho
墰	fsjh
霦	fsse
塛	fssy
雬	fsu
圫	ftan
埄	ftdh
墧	ftdk
塳	ftdp
垁	ftdy
耂	fte
郉	ftfb
圲	ftfh
垳	ftfh
幵	ftfh
雮	ftfn
埵	ftgf
堹	ftgf
耊	ftgf
壎	ftgo
垍	fthg
鼒	fthn
殾	ftjc
乽	ftjn
煑	ftjo
覩	ftjq
塲	ftjr
斱	ftjr
垎	ftkg
塩	ftkl
墺	ftmd
塮	ftmf
霺	ftmt
墦	ftol
耇	ftqk
耉	fttk
垀	ftuh
雽	ftuh
塖	ftux
耈	ftxk
坆	fty
攼	fty
圦	ftyy
垪	fuah
埢	fudb
堘	fudf
垟	fudh
墡	fudk
達	fudp
壠	fued
靇	fued
雴	fuf
報	fufc
騺	fufc
壌	fufe
褺	fufe
墊	fuff
坢	fufh
漐	fufi
縶	fufi
蟄	fufj
盩	fufl
贄	fufm
慹	fufn
鷙	fufo
逹	fufp
摯	fufr
執	fufy
瓡	fufy
謺	fufy
垶	fuh
墥	fujf
堷	fujg
墹	fujg
増	fulj
墑	fumd
塝	fupy
壛	fuqv
墫	fusf
壿	fusf
塧	fuwl
霠	fuwn
赱	fuyu
垏	fvfh
壗	fvhl
埐	fvpc
堄	fvqn
堖	fvtq
邞	fwbh
塕	fwcn
塅	fwdc
垘	fwdy
鄻	fwfb
鄼	fwfb
驇	fwfc
坴	fwff
暬	fwfj
勎	fwfl
勢	fwfl
輦	fwfl
賛	fwfm
熱	fwfo
燅	fwfo
鵱	fwfo
摰	fwfr
槷	fwfs
坿	fwfy
埶	fwfy
埨	fwga
堬	fwgj
垥	fwgk
墖	fwgl
墱	fwgu
霯	fwgu
鬹	fwhh
規	fwhq
槼	fwhs
嫢	fwhv
圿	fwjh
堢	fwks
鬶	fwmh
椝	fwms
鼀	fwmv
垖	fwnn
塢	fwno
塠	fwnp
夌	fwtu
雰	fwvb
坋	fwvn
鳱	fwvo
嗇	fwwk
﨏	fwwk
賫	fwwm
鳺	fwwo
墢	fwxc
坽	fwyc
坅	fwyn
靍	fwyo
鸖	fwyo
靃	fwyy
毐	fxdr
堟	fxey
塡	fxhw
坲	fxjh
堦	fxxr
霛	fxxx
壪	fxyx
墌	fyao
壙	fyaw
雱	fyb
墎	fybb
霩	fybb
埻	fybg
垿	fycb
堉	fyce
霅	fyf
圡	fyi
靄	fyjn
壞	fyle
壇	fylg
壈	fylt
塙	fymk
塶	fynx
塆	fyox
埌	fyve
霽	fyvf
埣	fywf
墇	fujh
镙	ffff
龪	fhwi
龳	fqff
龺	fjh
龼	fhph
鿍	ftah
鿨	flgq
鿾	fyvb
丣	gjan
勣	gmlt
彧	gkgy
玏	glt
珁	ggny
珬	gdgy
珴	gtry
珹	gdny
珻	gtxy
琇	gtet
琖	gaay
琯	gphn
琲	ghdd
瑇	ggxy
瑊	gdgy
璢	ggjl
璣	gxxy
璵	gvgw
瓅	grxs
瓧	gnnf
瓩	gnnf
瓪	gnnc
瓰	gnnv
瓱	gnnn
瓲	gnnn
瓸	gnnj
瓼	gnnf
甅	gnnf
甎	gjhy
畱	gjal
臹	gcfy
邷	gnnb
麹	gqqo
麺	gqdd
昋	gdjf
亞	gfgd
堊	gfgf
蝁	gfgj
惡	gfgn
鵶	gfgo
琧	gfgy
夒	ghtt
叀	gmcu
鼇	gqtx
麸	gtfw
璛	gvfj
纛	gxgi
璾	gyjg
叓	gkhc
璂	gadf
弐	gafd
玵	gafg
瓂	gafl
玒	gag
璍	gagf
璼	gahl
虣	gahm
鵡	gaho
玡	gaht
畱	gajl
丣	gajn
琙	gakg
瓘	gaky
貮	gami
璊	gamy
玴	gann
烎	gaou
璥	gaqt
璓	gate
瓁	gawc
鳽	gawo
瑹	gawt
雃	gawy
瑘	gbbh
瓍	gbdp
邨	gbnb
旾	gbnj
頓	gbnm
迍	gbnp
璚	gcbk
瑈	gcbs
戩	gcca
晉	gccj
臶	gcfb
臸	gcff
臵	gcfk
鵄	gcfo
臹	gcft
珆	gckg
玧	gcqn
丟	gcu
瑪	gcy
瑵	gcyj
珛	gdeg
瓇	gdet
栞	gdfs
蝅	gdgj
蠺	gdgj
珬	gdgt
瑊	gdgt
珔	gdhb
玤	gdhh
沗	gdiu
琲	gdjd
奣	gdje
瑌	gdmd
頊	gdmy
珹	gdnt
迗	gdpi
瓑	gdth
璙	gdui
琫	gdwh
瑃	gdwj
鴌	gdwo
瑧	gdwt
琈	gebg
郬	gebh
靜	geeh
珇	gegg
郙	gehb
尃	gehf
盙	gehl
乶	gehn
懯	gehn
鵏	geho
靚	gehq
喸	gehx
旉	gehy
靗	geiq
璦	gept
靘	geqc
	geqg
靔	gern
靝	gero
瑫	gevg
鶄	gewo
邘	gfbh
瓀	gfdj
珪	gffg
玕	gfh
瑱	gfhw
琎	gfjp
瓄	gflm
璹	gfnf
瓙	gfno
琽	gftj
珯	gftx
瓉	gfwm
玞	gfwy
珷	ggah
璢	ggal
璷	gget
玗	ggfh
玨	ggg
	gggg
璱	gggt
瑼	ggjf
璤	ggjn
珸	ggkg
瓎	ggkm
瑓	ggli
玙	ggng
珁	ggnn
瑨	ggoj
琹	ggsu
玶	gguh
珡	ggwu
瑇	ggxu
瓛	ghad
瓐	ghal
頙	ghdm
靕	ghge
堊	ghgf
亞	ghgg
蝁	ghgj
惡	ghgn
鵶	ghgo
琧	ghgy
琡	ghic
琸	ghjh
丅	ghk
颪	ghmj
乤	ghnb
亙	ghng
丏	ghnn
璿	ghph
現	ghqn
鴊	ghwo
玼	ghxn
璖	gias
奀	gidu
琑	gieg
琺	gifc
覔	gihq
盃	gilf
瑣	gimy
瑺	giph
璫	gipl
珖	giqn
嫑	gisv
珰	givg
珱	givg
鴀	giwo
卝	gjgd
瑅	gjgh
刯	gjgj
茍	gjgk
瑒	gjgr
蘷	gjgt
羐	gjgy
雈	gjgy
刬	gjh
鄟	gjhb
叀	gjhc
專	gjhf
珅	gjhh
剸	gjhj
甎	gjhn
鷒	gjho
東	gjii
鶇	gjio
琩	gjjg
瑥	gjlg
郠	gjqb
甦	gjqg
瑆	gjtg
璟	gjyi
琝	gjyy
郚	gkbh
琄	gkeg
丗	gkgd
珵	gkgg
帯	gkgh
羋	gkgh
玔	gkh
嚢	gkhe
蟗	gkhj
璝	gkhm
櫜	gkhs
栆	gkhu
珿	gkhy
勅	gkil
賴	gkim
頼	gkim
慗	gkin
鵣	gkio
鶒	gkio
鷘	gkio
遫	gkip
遬	gkip
揧	gkir
辢	gkiu
欶	gkiw
亜	gkjg
悪	gkjn
璪	gkks
畐	gklf
疈	gkll
鶝	gklo
鞷	gkmf
鹝	gkmg
鬸	gkml
鷊	gkmo
鬺	gkmr
鬷	gkmt
鬴	gkmy
逜	gkpd
敔	gkty
郖	gkub
豍	gkuf
剅	gkuj
頭	gkum
毭	gkun
豏	gkuo
剚	gkvj
珚	gldy
環	glge
畺	glgg
玾	glh
鶫	glio
卌	glk
珕	glll
瓃	glll
玏	gln
璉	glpy
琾	glwj
琠	gmaw
珃	gmfg
琱	gmfk
専	gmfu
珮	gmgh
珟	gmgq
靑	gmhg
	gmhg
巿	gmhk
帀	gmhk
鳾	gmho
迊	gmhp
兩	gmhy
朿	gmii
棗	gmii
敇	gmit
僰	gmiw
曺	gmjf
襾	gmjg
勣	gmln
両	gmmk
瓔	gmmv
恵	gmnu
責	gmu
瓗	gmwk
琌	gmwn
珼	gmy
酈	gmyb
彨	gmye
彲	gmye
玬	gmyg
鸝	gmyo
邐	gmyp
婯	gmyv
麗	gmyx
瑉	gnaj
珝	gng
瑂	gnhg
瑋	gnhh
玌	gnn
玘	gnn
戸	gnr
玚	gnrt
珌	gntt
攷	gnty
忢	gnu
丂	gnv
璆	gnwe
玦	gnwy
邷	gnyb
瓪	gnyc
璻	gnyf
瓧	gnyf
瓩	gnyf
瓼	gnyf
甅	gnyf
夨	gnyi
瓸	gnyj
瓱	gnyn
瓲	gnyn
瓰	gnyv
慭	godn
鄑	gogb
璘	goqh
辷	gpd
迋	gpd
琓	gpfq
瑄	gpgg
琔	gpgh
璸	gpgm
璌	gpgw
琿	gplh
璭	gplp
琯	gpnn
瑸	gprw
瑢	gpwk
瑏	gpwt
殘	gqaa
殣	gqag
殢	gqah
琘	gqaj
尶	gqal
殜	gqas
琋	gqdh
殗	gqdn
殑	gqdq
殝	gqdt
殎	gqdw
豗	gqei
殱	gqfg
殰	gqfm
殏	gqfy
琻	gqg
殌	gqga
尫	gqgd
殭	gqgg
殐	gqgi
殩	gqho
珎	gqiy
珣	gqjg
	gqjg
劽	gqjl
殟	gqjl
烮	gqjo
鮤	gqjo
鴷	gqjo
迾	gqjp
銐	gqjq
姴	gqjv
殫	gqkf
玽	gqkg
殞	gqkm
殨	gqkm
	gqkm
殬	gqlf
瑍	gqmd
瓊	gqmt
玸	gqnn
殯	gqpm
殥	gqpw
卼	gqqb
歿	gqqc
殙	gqqj
歾	gqqr
歽	gqrh
瑤	gqrm
珋	gqtb
驁	gqtc
殀	gqtd
殠	gqtd
殅	gqtg
嗸	gqtk
殈	gqtl
嶅	gqtm
贅	gqtm
鰲	gqto
鷔	gqto
摮	gqtr
殤	gqtr
嫯	gqtv
鼇	gqtv
謷	gqty
殕	gquk
兀	gqv
琤	gqvh
肂	gqvh
殔	gqvi
飱	gqwe
殲	gqwg
殦	gqwo
殮	gqww
瑠	gqyl
殧	gqyn
玓	gqyy
瑝	grgg
璳	grim
瑔	griy
璑	grlo
珤	grmh
瓆	grrm
琕	grtf
璬	gryt
膥	gsdw
唜	gskx
璴	gssh
瑮	gssy
琜	gsww
麺	gtdd
琒	gtdh
琇	gten
珘	gtey
玝	gtfh
瓚	gtfm
珽	gtfp
珗	gtfq
珄	gtgg
琍	gtjh
瑀	gtky
珦	gtmk
琁	gtnh
璠	gtol
瓈	gtqi
麹	gtqo
珴	gtrt
瑽	gtwh
珻	gtxu
瑳	guda
珜	gudh
琷	gudn
瓏	gued
瑐	guej
璲	guep
瓓	gugi
璄	gujq
琣	gukg
璔	gulj
瓋	gump
珓	guqy
亊	guvh
刾	guwj
頬	guwm
珶	guxt
巠	gvaf
璕	gvaf
剄	gvaj
勁	gval
頸	gvam
鵛	gvao
逕	gvap
巰	gvaq
珢	gvey
坙	gvff
珒	gvfh
郪	gvhb
璛	gvhh
疌	gvhi
璶	gvhl
鶈	gvho
琭	gviy
璅	gvjs
玿	gvkg
玱	gwbn
玜	gwcy
瑖	gwdc
璵	gwfw
璯	gwgj
珨	gwgk
璒	gwgu
玠	gwjh
壐	gwmf
蠒	gwmj
鸍	gwmo
邇	gwmp
爾	gwmq
覼	gwmq
璽	gwmy
瑡	gwnh
瑦	gwno
兲	gwu
鳿	gwvo
玐	gwy
琟	gwyg
琀	gwyk
瑲	gwyk
玪	gwyn
璡	gwyp
瑑	gxey
瑻	gxfm
璏	gxgx
繛	gxij
瓅	gxrs
鴺	gxwo
玭	gxxn
瑎	gxxr
璣	gxxt
珫	gycq
珳	gyet
琂	gyg
玣	gyhy
玊	gyi
瓖	gyke
瓌	gyle
璮	gylg
瑯	gyvb
璾	gyvf
琗	gywf
玹	gyxy
璈	ggqt
琖	gaat
嘅	gghg
孳	gcff
枰	gudn
翴	glfl
蚗	ggll
龶	gghg
鿞	gqjq
鿪	gweo
鿱	gcn
鿲	gkul
鿺	gtqg
鿿	gehi
剕	hdhj
奜	hdhd
婓	hdhv
戱	haja
棐	hdhs
歲	hdgy
歳	hdgy
猆	hdhd
甗	hagy
眆	hyt
眑	hxlt
眓	hany
眬	hdxt
睋	htry
虛	hajg
輩	hdhl
靟	hdhn
餥	hdhe
鹵	hlou
鹶	hlon
鹷	hloc
鹸	hlow
鹹	hloy
鹺	hloa
鹻	hloo
鹼	hlow
齥	hbjt
齰	hbaj
齛	hban
齖	hbat
齱	hbbc
齝	hbck
齮	hbdk
齟	hbeg
齻	hbfw
齬	hbgk
齜	hbhx
齒	hbj
齥	hbjx
齵	hbjy
齪	hbkh
齶	hbkn
齞	hbkw
齫	hbls
齷	hbnf
齓	hbnn
齳	hbpl
齣	hbqk
齙	hbqn
齺	hbqt
齗	hbrh
齭	hbrr
齼	hbsh
齽	hbsi
齚	hbtf
齕	hbtn
齲	hbty
齴	hbue
齸	hbul
齩	hbuq
齦	hbve
齨	hbvg
齠	hbvk
齯	hbvq
齡	hbwc
齘	hbwj
齔	hbxn
鬮	hggx
瞜	hlvg
瞗	hwvo
瞸	haas
睰	hadk
皻	haec
虘	haeg
豦	haei
劇	haej
勮	hael
覰	haeq
戲	haga
齾	hagb
獻	hagd
瞱	hagf
鬳	hagh
甗	hagn
覻	hagq
頥	hahm
瞙	hajd
瞘	hakk
鸆	hako
矔	haky
膚	hale
矒	halh
勴	hall
盧	hall
虜	hall
顱	halm
慮	haln
鸕	halo
虥	hama
甝	hamf
虤	hamm
贙	hamm
虪	hamo
覤	hamq
虝	hamr
瞞	hamy
戱	hana
歫	hang
虛	hang
眓	hant
虙	hant
戯	haoa
覷	haoq
歔	haow
虡	haow
矇	hape
	haqt
	haqt
虗	harg
虨	hase
虖	hath
處	hatm
歑	hatw
矆	hawc
虧	hawn
雐	hawy
眲	hbg
瞲	hcbk
頗	hcdm
皯	hcfh
皹	hcpl
皰	hcqn
矋	hday
郹	hdbh
睳	hdff
劌	hdgj
顪	hdgm
翽	hdgn
歲	hdgt
歳	hdgt
盽	hdhh
頉	hdmy
	hdqg
狊	hdu
睶	hdwj
鶪	hdwo
眬	hdxn
眀	heg
瞹	hept
睜	hevh
睵	hfak
眃	hfcy
歭	hffy
盰	hfh
瞋	hfhw
眎	hfiy
眛	hfiy
瞦	hfkk
盶	hfqn
瞡	hfwq
睖	hfwt
矐	hfwy
眰	hgcf
丄	hgd
鬦	hggf
鬪	hggf
鬮	hggg
鬥	hggh
鬧	hggh
鬩	hggq
鬬	hggr
鬭	hggr
鬫	hggt
鬨	hggw
眐	hghg
眪	hgmw
矖	hgmx
歵	hgmy
瞔	hgmy
眜	hgsy
眱	hgxw
矑	hhal
瞁	hhdy
歮	hhhf
瞐	hhhf
亅	hhll
鼑	hhnn
愳	hhnu
煛	hhou
瞾	hhpa
鷪	hhpo
睍	hhqn
歨	hhu
戵	hhwa
鸜	hhwo
裻	hice
惄	hicn
錖	hicq
顰	hidf
頻	hidm
睄	hieg
敊	hihc
矘	hipo
縣	hiti
懸	hitn
歩	hitr
尗	hiu
睅	hjfh
睼	hjgh
眒	hjhh
逴	hjpk
児	hjqb
睗	hjqr
睲	hjtg
鵫	hjwo
梷	hkcs
頕	hkdm
奌	hkdu
睊	hkeg
睈	hkgg
瞜	hkgv
敁	hkhc
瞆	hkhm
瞶	hkhm
覘	hkhq
瞣	hkkn
矂	hkks
迠	hkpd
眖	hkqn
盀	hlf
睤	hlgj
逌	hlnp
鹺	hlqa
禼	hlqc
鹷	hlqc
鹶	hlqn
鹵	hlqo
鹻	hlqo
鹹	hlqt
鹸	hlqw
鹼	hlqw
卥	hlry
睏	hlsy
欳	hmaw
睓	hmaw
眏	hmdy
睭	hmfk
眮	hmgk
卨	hmnk
遉	hmpi
貞	hmu
凣	hmv
睱	hnhc
睸	hnhg
矚	hnij
県	hniu
郻	hnvb
矅	hnwy
眤	hnxn
齢	hobc
歯	hobj
瞨	hogy
睒	hooy
瞇	hopy
	hovg
肻	hpef
睆	hpfq
叡	hpgc
壡	hpgf
睻	hpgg
矉	hpgm
瞚	hpgw
睴	hplh
矃	hpns
睕	hpqb
眝	hpsh
敹	hptt
睧	hqaj
眂	hqan
眡	hqay
見	hqb
覎	hqbd
韰	hqcg
睎	hqdh
覞	hqhq
眴	hqjg
眗	hqkg
眳	hqkg
睌	hqkq
矎	hqmt
覐	hqqq
覹	hqtt
歺	hqu
盷	hqug
眅	hrcy
眽	hrey
瞃	hrfh
盺	hrh
瞴	hrlo
矈	hrpy
眣	hrwy
瞫	hsjh
睞	hsww
歬	hteu
眊	htfn
歱	htgf
矄	htgo
矏	hthy
矀	htmt
盵	htnn
矁	hton
睋	htrt
瞗	htvo
瞛	htwh
睠	hudb
眻	hudh
眹	hudy
矓	hued
瞯	hueg
眫	hufh
瞤	hugg
瞷	hujg
瞕	hujh
矙	hunt
睷	hvfp
睩	hviy
眧	hvkg
龁	hwbn
龂	hwbr
瞈	hwcn
眕	hwet
睔	hwga
睮	hwgj
瞺	hwgj
盻	hwgn
瞼	hwgw
睺	hwnd
辪	hwnu
仧	hwu
鳪	hwvo
齒	hwwb
齡	hwwc
齱	hwwc
齦	hwwe
齴	hwwe
睉	hwwf
齚	hwwf
齷	hwwf
齟	hwwg
齪	hwwh
齼	hwwh
齽	hwwi
齘	hwwj
齰	hwwj
齝	hwwk
齠	hwwk
齣	hwwk
齬	hwwk
齮	hwwk
齳	hwwl
齸	hwwl
齓	hwwn
齕	hwwn
齙	hwwn
齛	hwwn
齶	hwwn
齩	hwwq
齯	hwwq
齗	hwwr
齭	hwwr
齫	hwws
齖	hwwt
齺	hwwt
齨	hwwv
齞	hwww
齻	hwww
齔	hwwx
齜	hwwx
齥	hwwx
齲	hwwy
齵	hwwy
祡	hxfi
眥	hxhf
歶	hxjy
呰	hxkf
啙	hxkk
眑	hxln
貲	hxmu
胔	hxmw
鈭	hxqf
鮆	hxqo
矊	hxrh
姕	hxvf
飺	hxwe
鴜	hxwo
矌	hyaw
瞝	hybc
瞮	hyct
眆	hyn
睙	hynd
眿	hyni
盳	hynn
瞊	hyvk
睟	hywf
盿	hyy
鈌	hhgg
龰	hhgy
龾	hcqo
鿃	hdty
鿃	hdww
労	iplr
氻	ilt
汸	iyt
沑	inhf
泑	ixlt
泧	iany
洩	ijnt
浌	iway
涐	itry
涶	itfg
淓	iayt
淺	iaay
渄	ihdd
減	idgy
溕	ipfe
滅	idgy
潒	iqke
澑	igjl
濈	ikby
濊	ihdy
濼	irxs
瀎	ialy
灃	imdu
灚	ivqq
灣	iyxx
灤	iyxs
灧	imdc
灩	imdl
瓽	ipky
瀟	iavj
鼝	ijgc
淵	ijgg
漊	ilvg
潚	ivfj
澠	ixg
済	iyjg
濟	iyjg
灆	iaal
淺	iaat
濝	iadi
渃	iadk
澒	iadm
頮	iadm
颒	iadm
浳	iaeg
潵	iaet
濭	iafl
湈	iafs
澕	iagf
洭	iagg
淽	iahg
洍	iahh
瀶	iahk
濫	iahl
灠	iahq
濗	iajh
澫	iajy
淢	iakg
漌	iakg
漚	iakk
漢	iakw
灘	iaky
渵	ialg
瀎	ialt
渶	iamd
満	iamm
懣	iamn
滿	iamy
洰	iang
泧	iant
濛	iape
溁	iaps
滯	iaqh
灊	iaqh
潛	iaqj
懘	iaqn
濍	iaqn
渮	iask
灡	iaui
瀟	iavh
濩	iawc
溚	iawk
濸	iawk
鴻	iawo
鍙	iawq
滙	iawy
淓	iayn
瀳	iayo
灄	ibbb
瀡	ibdp
汓	ibg
滍	ibhj
洆	ibig
濻	ibkm
泏	ibmh
氾	ibn
漋	ibtg
汿	icbh
沀	icbh
潏	icbk
滪	icbm
澦	icbm
渘	icbs
涰	iccc
滲	icce
湧	icel
慂	icen
沇	icqn
洠	icrh
涘	ictd
溤	icy
溞	icyj
濿	iday
汯	idcy
沷	idcy
瀀	idet
涱	idey
沯	idf
渀	idfa
浱	idfe
漘	idfe
滣	idfk
洿	idfn
沰	idg
澸	idgn
減	idgt
滅	idgt
洊	idhb
灧	idhc
湱	idhd
潔	idhi
灩	idhl
灃	idhu
洡	idiy
渄	idjd
湹	idjf
洦	idjg
渜	idmd
洏	idmj
湏	idmy
浝	idne
沋	idnn
厳	idnt
洃	idoy
	idpy
漺	idqq
渏	idsk
瀝	idth
湊	idwd
淎	idwh
溙	idwi
湷	idwj
浹	idww
汏	idy
汱	idy
濦	iean
溋	iecl
淜	ieeg
湲	iefc
瀦	iefj
渓	iefw
浖	iefy
漞	iehq
揱	iejr
灂	ielf
涭	iepc
滛	ierm
潙	ieto
浽	ievg
淨	ievh
鸂	iexo
瀐	ifag
泋	ifah
渽	ifak
濆	ifam
溨	ifas
瀻	ifaw
汥	ifcy
沄	ifcy
坔	iff
澐	iffc
湗	ifff
澆	iffq
洔	iffy
汢	ifg
淔	ifhg
沬	ifiy
沶	ifiy
浗	ifiy
溝	ifjf
澣	ifjf
濣	ifjf
汫	ifjh
漧	ifjn
溒	ifke
瀆	iflm
湳	ifmf
濤	ifnf
汚	ifnn
浾	ifoy
浡	ifpb
濲	ifpc
瀔	ifpc
瀫	ifpc
溹	ifpi
涜	ifpq
潱	ifpu
灀	ifsh
瀮	ifss
涍	iftb
洘	iftn
漖	iftt
涬	ifuf
澾	ifup
澪	ifwc
淕	ifwf
濇	ifwk
濽	ifwm
淩	ifwt
瀖	ifwy
汧	igah
澑	igal
洷	igcf
濪	igec
瀞	igeh
汙	igfh
盓	igfl
潖	iggc
濏	iggt
泟	ighg
漹	igho
漙	igjf
涷	igji
潓	igjn
浭	igjq
灢	igke
滆	igkh
溂	igkj
瀜	igkj
湢	igkl
瀨	igkm
瀬	igkm
潄	igkt
浢	igku
湅	igli
洅	igmf
淸	igmg
沞	igmh
洓	igmi
灑	igmx
漬	igmy
汅	ignn
溍	igoj
滶	igqt
泙	iguh
涇	igva
湽	igvl
淒	igvv
濔	igwq
溼	igxf
沍	igxg
溸	igxi
洟	igxw
澞	ihad
滮	ihae
澽	ihae
瀘	ihal
淲	iham
濾	ihan
碆	ihcd
錃	ihcq
濊	ihdt
湨	ihdy
沚	ihg
澁	ihhh
灈	ihhy
瀕	ihim
渉	ihit
渋	ihiy
惉	ihkn
滷	ihlo
湞	ihmy
濎	ihnn
濬	ihph
覍	ihqb
涀	ihqn
澯	ihqo
泚	ihxn
	ihyt
氺	ihyy
濷	iiay
尛	iiiu
渁	iiiy
涾	iijg
溑	iimy
漟	iipf
澢	iipl
灙	iipo
洸	iiqn
硰	iitd
渻	iith
乷	iitn
鯊	iito
逤	iitp
桬	iits
沝	iiy
滭	ijaf
渱	ijag
戦	ijfa
溡	ijff
濹	ijff
浬	ijfg
涆	ijfh
単	ijfj
濐	ijfj
淏	ijgd
泹	ijgg
浉	ijgh
湜	ijgh
盪	ijgl
燙	ijgo
湯	ijgr
璗	ijgy
虩	ijim
滉	ijiq
淐	ijjg
澷	ijly
湡	ijmy
渇	ijqx
巣	ijsu
淉	ijsy
湦	ijtg
灦	ijxm
濕	ijxo
洩	ijxt
灗	ijyg
澋	ijyi
灝	ijym
渂	ijyy
湒	ikbg
濈	ikbt
浥	ikcn
呇	ikf
洖	ikgd
塣	ikgf
浧	ikgg
漊	ikgv
汌	ikh
沖	ikhh
潰	ikhm
瀢	ikhp
潬	ikkf
澏	ikkm
湂	ikkn
涢	ikmy
溳	ikmy
況	ikqn
漍	ilag
潩	ilaw
瀱	ildj
泴	ilf
畄	ilf
畓	ilf
澤	ilff
濖	ilfj
潶	ilfo
沺	ilg
獣	ilgd
渨	ilge
澴	ilge
泇	ilkg
灅	illf
氻	iln
潿	ilnh
漣	ilpy
濁	ilqj
聻	ilrb
魙	ilrc
壍	ilrf
漸	ilrh
嬱	ilrv
涃	ilsy
溿	iluf
瀭	ilwj
溫	ilwl
溭	ilwt
潀	ilwy
濺	imaa
灔	imac
浀	imag
灎	imal
淟	imaw
漄	imdf
湠	imdo
漰	imee
鼡	imfh
淍	imfk
涄	imgn
洬	imgq
溦	imgt
澂	imgt
溰	imgu
澠	imgv
測	imjh
瀃	imjr
潉	imjx
尙	imkf
泂	imkg
幤	imkh
瀴	immv
渦	imnk
濄	imnp
漴	impi
沨	imqy
溄	imth
渢	imtj
潂	imug
浻	imwk
汭	imwy
漼	imwy
浿	imy
浵	imye
盕	imyl
汎	imyy
澱	inac
湣	inaj
淈	inbm
涺	indg
沑	infg
潳	infj
汈	ingg
泀	ingk
溊	inhc
湑	inhe
湋	inhh
漽	inih
灟	inij
浺	inkh
澼	inku
瀷	inlw
潠	innw
瀈	inpl
漝	inrg
湉	intd
浘	intn
泦	invn
漻	inwe
決	inwy
埿	inxf
濢	inyf
瀥	inyk
浕	inyu
泤	inyw
沢	inyy
灇	iogc
濧	iogf
澲	iogw
濴	iooi
瀠	iooi
瀯	iook
澇	iool
濙	iooo
灐	iooq
濚	ioos
瀅	iooy
潾	ioqh
溇	iovg
洣	ioy
	ipb
敩	ipbt
浤	ipdc
瀗	ipdn
涋	ipdy
滱	ipfc
坣	ipff
瀽	ipfh
溕	ipge
濱	ipgm
漃	iphc
覚	iphq
蛍	ipju
甞	ipkf
劏	ipkj
嘗	ipkj
営	ipkk
當	ipkl
賞	ipkm
瓽	ipkn
黨	ipko
牚	ipkt
労	iplb
渾	iplh
峃	ipmj
澝	ipne
滵	ipnm
濵	ipnm
濘	ipns
淧	ipnt
涴	ipqb
鸴	ipqg
浶	iprh
栄	ipsu
浨	ipsy
瀋	iptl
濅	ipvc
洝	ipvg
瀉	ipvo
涳	ipwa
湥	ipwd
浫	ipwf
漥	ipwf
潌	ipwf
滘	ipwk
鴬	ipwo
泬	ipwy
溛	ipwy
涽	iqaj
汦	iqan
滐	iqas
黋	iqaw
泜	iqay
沒	iqcy
洈	iqdb
頫	iqdm
澥	iqeh
澛	iqgj
覜	iqhq
沵	iqiy
潒	iqje
尡	iqjx
泃	iqkg
洺	iqkg
瀺	iqky
渙	iqmd
韑	iqnh
瀂	iqoj
淗	iqoy
漁	iqoy
輝	iqpl
濥	iqpw
洶	iqqb
淴	iqrn
沕	iqrt
汮	iqug
淊	iqvg
浄	iqvh
盜	iqwl
鴵	iqwo
渹	iqyg
瀏	iqyj
兤	iqyw
汋	iqyy
汣	iqyy
汳	ircy
泒	ircy
滜	irdf
垽	irff
洉	irgk
汼	irhh
沠	irhy
湶	iriy
潕	irlo
淿	irmh
峾	irmj
淛	irmj
滊	irno
溾	irqc
渒	irtf
澔	irtk
溵	irvc
湁	irwk
泆	irwy
潅	irwy
漑	irxq
泝	iryy
涁	iset
溎	isff
渿	isfi
泍	isgg
滒	iskk
潥	isoy
灪	isre
湐	isrg
漜	issf
濋	issh
澿	issi
澘	issj
潹	isss
滼	issy
瀒	iswk
淶	isww
汑	itan
澨	itaw
浲	itdh
潪	itdj
漨	itdp
瀊	itel
洀	itey
汘	itfh
汻	itfh
洐	itfh
濳	itfj
灒	itfm
涏	itfp
鍌	itfq
涶	itgf
湩	itgf
泩	itgg
湰	itgg
鼝	ithc
泎	ithf
淵	ithh
漇	ithh
沜	ithn
浰	itjh
漡	itjr
渪	itky
潈	itle
潨	itli
漗	itln
瀩	itmm
澚	itmn
瀓	itmt
泲	itnt
涐	itrt
潃	itte
毟	ittn
澓	ittt
泘	ituh
溗	itux
泈	ituy
瀄	itvb
涹	itvg
潷	itvh
漎	itwh
潻	itwi
塰	itxf
瀿	itxi
湚	itxn
汷	ity
洴	iuah
渆	iuaj
溠	iuda
淃	iudb
溬	iudc
瀁	iude
漛	iudi
潫	iudi
渕	iudj
浂	iudy
瀧	iued
湇	iueg
澻	iuep
渼	iugd
潤	iugg
瀾	iugi
溔	iugo
湵	iugy
湆	iujg
澗	iujg
灨	iujm
滝	iujn
澺	iujn
滰	iujq
滾	iuke
灛	iukf
涚	iukq
渷	iukq
潧	iulj
滳	iumk
潎	iumt
湴	iuog
潽	iuoj
渧	iuph
澬	iuqm
滧	iuqt
洨	iuqy
灁	iuri
澊	iusf
湭	iusg
瀙	iusq
澵	iusr
澖	iusy
濶	iutd
滻	iutg
渞	iuth
濓	iuto
浐	iutt
灍	iuuw
淁	iuvg
溓	iuvo
濨	iuxn
潣	iuyy
潯	ivaf
湼	ivag
泿	ivey
堻	ivff
澅	ivfg
湕	ivfp
澙	ivgo
潚	ivhh
濜	ivhl
漅	ivjs
灉	ivky
氿	ivn
淣	ivqn
潟	ivqo
涒	ivtk
澀	ivyh
涊	ivyn
汍	ivyy
浌	iwat
滃	iwcn
洑	iwdy
洕	iweg
鹡	iweg
鶺	iweo
沴	iwet
漈	iwfi
涻	iwfk
溌	iwfq
灚	iwfq
泭	iwfy
淪	iwga
渰	iwga
湀	iwgd
洤	iwgg
澮	iwgj
潝	iwgn
瀲	iwgt
澰	iwgw
滫	iwhe
滺	iwhn
滌	iwhs
浟	iwht
涗	iwkq
湺	iwks
溮	iwnh
溩	iwno
挙	iwrj
潊	iwtc
塗	iwtf
漵	iwtt
氼	iwu
涖	iwug
洢	iwvt
溣	iwwa
瀸	iwwg
潑	iwxc
沎	iwxn
汃	iwy
汄	iwy
湌	iwye
準	iwyf
蠽	iwyj
浛	iwyk
滄	iwyk
汵	iwyn
淰	iwyn
潐	iwyo
潗	iwys
渳	ixbg
漲	ixde
湪	ixey
淥	ixgi
瀰	ixgq
漒	ixkj
泑	ixln
濼	ixrs
濰	ixwy
沘	ixxn
湝	ixxr
灤	ixys
灣	ixyx
瀇	iyaw
漷	iybb
涥	iybh
潡	iybt
灕	iyby
淯	iyce
瑬	iycy
乼	iygn
涼	iyiy
済	iyjf
瀍	iyjf
湻	iyjg
滖	iyke
瀼	iyke
瀤	iyle
澟	iylt
滈	iymk
汸	iyn
滬	iync
灋	iync
涙	iynd
淚	iynd
汒	iynn
瀌	iyno
淭	iyns
灜	iyny
湙	iyod
洂	iyoy
湸	iypm
渟	iyps
灖	iysd
湤	iytb
滸	iytf
溈	iyto
尐	iyu
濟	iyvf
滽	iyvh
漮	iyvi
滀	iyxl
澭	iyxy
淂	ijgf
濃	imae
哖	ipbf
潀	ilwu
潅	itdy
秥	ipbf
龸	ipb
鿄	ivys
鿌	iyji
鿰	ifjh
旫	jvt
昉	jyt
昐	jwvt
昘	jyr
昮	jalr
昽	jdxt
晀	jqiy
晠	jdny
暃	jhdd
曅	jagh
曣	jako
曵	jnty
朂	jblr
虭	jvt
蚄	jyt
蚡	jwvt
蜏	jtet
蝛	jdgy
蝳	jgxy
蟣	jxxy
蟻	jugy
蠨	javj
鼂	jgxf
蜵	jjgg
螻	jlvg
蟰	jvfj
蠅	jxg
蠐	jyjg
暱	jaak
蠂	jaas
昻	jabj
蠎	jada
蟖	jadr
畢	jafk
鷝	jafo
曄	jagf
曅	jagf
暯	jajd
蝘	jajv
蠇	jajy
螼	jakg
暵	jakw
蠸	jaky
昮	jalb
蠴	jalj
暎	jamd
蝧	jamd
曂	jamw
蜹	jamw
暪	jamy
蟎	jamy
昛	jang
蚷	jang
煚	jano
曚	jape
螮	jaqh
曔	jaqt
蠮	jatn
曣	jauo
蠨	javh
蟏	javj
晎	jawy
謈	jawy
虸	jbg
蜬	jbib
蟶	jbkg
朂	jblb
曓	jbmf
昢	jbmh
虵	jbn
昪	jcaj
蝚	jcbs
蝃	jccc
蚆	jcn
晙	jcwt
螞	jcy
曞	jday
蠣	jday
蚅	jdbn
蛂	jdcy
蛕	jdeg
蜄	jdfe
晇	jdfn
鷐	jdfo
蟵	jdgf
蝛	jdgt
暳	jdhv
暃	jdjd
蛨	jdjg
昦	jdjj
晻	jdjn
蝒	jdmd
蝡	jdmd
暊	jdmy
蝢	jdmy
蛖	jdne
蚘	jdnn
晠	jdnt
旲	jdu
暸	jdui
蟟	jdui
蟩	jduw
蜯	jdwh
暙	jdwj
蛺	jdww
昽	jdxn
猒	jedy
冐	jef
蝯	jefc
蛶	jefy
蚏	jeg
勗	jegl
琞	jegy
焽	jeou
曌	jepa
曖	jept
暚	jerm
蟡	jeto
螇	jexd
昅	jeyy
蟦	jfam
暁	jfaq
蠘	jfay
蜐	jfcl
蚑	jfcy
曘	jfdj
黙	jfdo
圼	jff
曇	jffc
晆	jffg
曉	jffq
蟯	jffq
時	jffy
旪	jfh
虷	jfh
蛷	jfiy
蛣	jfkg
暿	jfkk
蟢	jfkk
暔	jfmf
黒	jfou
曀	jfpu
蚖	jfqn
暏	jftj
蝫	jftj
螧	jftj
蛯	jftx
蟽	jfup
曤	jfwy
蚈	jgah
旽	jgbn
晊	jgcf
蜅	jgey
旴	jgfh
虶	jgfh
蚟	jgg
昰	jghf
韙	jghh
題	jghm
鶗	jgho
遈	jghp
尟	jght
晸	jght
蚽	jgig
暷	jgjf
晅	jgjg
蝀	jgji
蝆	jgkf
螎	jgkh
曧	jgkj
蝲	jgkj
鼌	jgkn
暕	jgli
昁	jgmh
鼂	jgmv
昞	jgmw
昺	jgmw
蛃	jgmw
曬	jgmx
蜽	jgmy
蛚	jgqj
逿	jgqp
昜	jgqr
敭	jgqt
昩	jgsy
蚲	jguh
蛵	jgva
蜨	jgvh
鴠	jgwo
螦	jgxi
蝳	jgxu
蛦	jgxw
曥	jhal
蠦	jhal
蚾	jhcy
朄	jhgi
蠷	jhhy
晫	jhjh
暢	jhjr
曱	jhk
甴	jhk
蛅	jhkg
迧	jhpk
晛	jhqn
蜆	jhqn
畃	jhqy
毷	jhtn
蟕	jhxe
虲	jhy
蟝	jias
蝋	jimh
蟐	jiph
蟷	jipl
曭	jipo
晀	jiqn
晄	jiqn
晘	jjfh
昍	jjg
蚎	jjg
蝭	jjgh
暘	jjgr
蝪	jjgr
蝐	jjhg
曑	jjje
曟	jjje
晿	jjjg
曐	jjjg
曡	jjjg
蠱	jjjl
蝿	jjjn
蟲	jjju
蟃	jjlc
蝹	jjlg
焸	jjou
暥	jjpv
暍	jjqn
晹	jjqr
蠍	jjqw
暒	jjtg
蜫	jjxx
暻	jjyi
蜎	jkeg
冔	jkgf
螻	jkgv
蚛	jkhh
暺	jkkf
蟬	jkkf
曮	jkkt
蟈	jlag
鄤	jlcb
蝟	jleg
昷	jlf
曎	jlff
蠌	jlff
蟔	jlfo
蠉	jlge
蛼	jlh
蛠	jlll
蠝	jlll
蠋	jlqj
螹	jlrh
蜠	jlty
曪	jlxy
晪	jmaw
螖	jmeg
蚦	jmfg
晭	jmfk
晍	jmgk
暟	jmgu
螘	jmgu
蠅	jmgv
顒	jmhm
颙	jmhm
旵	jmj
蜖	jmjd
蠳	jmmv
蝸	jmnk
蛧	jmqq
蝄	jmun
蠵	jmwk
蛽	jmy
蚒	jmyg
蜛	jndg
蛡	jng
暅	jngg
蝦	jnhc
蝑	jnhe
蝞	jnhg
暐	jnhh
虯	jnhh
曯	jnij
蠾	jnij
蟤	jnnw
旸	jnrt
毾	jntn
蟉	jnwe
蚗	jnwy
蠗	jnwy
蚭	jnxn
蚇	jnyy
顕	jogm
曗	jogw
蟧	jool
蠑	joos
晱	jooy
暽	joqh
炚	joy
曢	jpdi
螛	jpdk
晥	jpfq
蝖	jpgg
蝊	jpgh
蠙	jpgm
螾	jpgw
暉	jplh
暈	jplj
晼	jpqb
鷃	jpvo
螲	jpwf
曻	jqah
蚔	jqan
蚳	jqay
蝬	jqbt
蛫	jqdb
晞	jqdh
曕	jqdy
蠏	jqeh
晩	jqjq
昫	jqkg
蚼	jqkg
蜔	jqlg
蝜	jqmy
蚫	jqnn
蛥	jqqy
敡	jqrc
蜪	jqrm
惖	jqrn
鶍	jqro
逷	jqrp
昒	jqrt
蚐	jqug
蜭	jqvg
鹖	jqwg
毼	jqwn
鶡	jqwo
欥	jqwy
旳	jqyy
虳	jqyy
昄	jrcy
蛌	jrcy
暤	jrdf
蚚	jrh
螔	jrhm
暭	jrif
蟱	jrlo
暣	jrno
螝	jrqc
晣	jrrh
昳	jrwy
蛈	jrwy
曒	jryt
蚸	jryy
顆	jsdm
褁	jseu
虰	jsh
敤	jshc
曋	jsjh
蟫	jsjh
晽	jssy
蜙	jswc
蚞	jsy
昇	jtaj
虴	jtan
蟜	jtdk
蜏	jten
旿	jtfh
晧	jtfk
蝩	jtgf
甠	jtgg
﨡	jtgg
蝂	jthc
螑	jthd
曍	jthf
蜵	jthh
暞	jths
蟍	jtjs
蛒	jtkg
蝺	jtky
蟌	jtln
螕	jtlx
晑	jtmk
蜁	jtnh
昸	jtuy
蜲	jtvg
暰	jtwh
暀	jtyg
蛢	juah
蟙	juaj
暛	juda
曨	jued
蠬	jued
蟻	jugt
曈	jujf
暲	jujh
螪	jumk
蠀	juqm
晈	juqy
螏	jutd
昗	juu
螊	juvo
螠	juwl
晜	juxt
螆	juxx
蟳	jvaf
蝍	jvcb
螁	jvep
蛝	jvey
妟	jvf
蟰	jvhh
曃	jvip
蛁	jvkg
蠟	jvln
旫	jvn
虭	jvn
晲	jvqn
蜺	jvqn
蟘	jwam
蚮	jway
暡	jwcn
螉	jwcn
昖	jwcy
昣	jwet
暩	jwfi
蚹	jwfy
蜦	jwga
螩	jwhs
蛻	jwkq
螄	jwnh
螐	jwno
蚥	jwqy
昐	jwvn
蚡	jwvn
蟂	jwvs
蛜	jwvt
昤	jwyc
蠄	jwyc
蜼	jwyg
蛿	jwyk
螥	jwyk
昑	jwyn
蚙	jwyn
蟭	jwyo
蝝	jxey
昲	jxjh
曊	jxjm
曏	jxtb
蜌	jxxf
鹍	jxxg
顯	jxxm
鵾	jxxo
蝔	jxxr
蟣	jxxt
歞	jxxw
曵	jxyi
蟅	jyao
曠	jyaw
昘	jyb
蜳	jybg
蜟	jyce
昿	jycy
蠩	jyfj
顥	jyim
蠰	jyke
蟺	jylg
暠	jymk
蚢	jymn
昉	jyn
蚄	jyn
蜧	jynd
昹	jyni
昈	jynt
晐	jynw
螰	jynx
蠔	jype
蝏	jyps
暆	jytb
暶	jyth
旻	jyu
蝷	jyut
蜋	jyve
蠐	jyvf
晬	jywf
蜶	jywf
昡	jyxy
蚿	jyxy
旼	jyy
韘	jjjj
魫	jvtk
龧	jjfj
勛	kmlt
叧	kvr
吜	knhf
呣	kxyy
咓	kgny
咷	kqiy
唀	ktet
喴	kdgy
嘜	kswq
嘰	kxxy
噦	khdy
嚛	krxs
嚥	kako
槑	kkss
瓹	kegy
趽	khyt
跩	khjt
踇	khty
躒	khrs
啞	kgfg
噁	kgfn
嚙	khbh
躋	khyj
鼉	kklx
嘍	klvg
嘯	kvfj
嚌	kyjg
啿	kadn
唭	kadw
囈	kafc
嚡	kaff
叿	kag
嘩	kagf
嚂	kahl
囕	kahq
嗼	kajd
唶	kajg
囆	kajj
噧	kajy
嘔	kakk
嘆	kakw
嚾	kaky
唝	kamy
嗊	kamy
呭	kann
噆	kaqj
囌	kaqt
囒	kaui
嚥	kauo
嚄	kawc
嗏	kaws
嚿	kawv
囁	kbbb
唨	kbeg
咠	kbf
吇	kbg
咡	kbg
吔	kbn
噊	kcbk
嘇	kcce
咍	kckg
嗎	kcy
吰	kdcy
嘠	kdea
喐	kdeb
哊	kdeg
嚘	kdet
喯	kdfa
啀	kdff
嗕	kdff
咵	kdfn
喴	kdgt
囓	kdhb
喫	kdhd
噄	kdhi
嚖	kdhn
嘒	kdhv
嚈	kdjd
咟	kdjg
唵	kdjn
喕	kdmd
咘	kdmh
順	kdmy
哤	kdne
嚦	kdth
唊	kdww
哹	kebg
啂	kebn
肙	kef
喛	kefc
哷	kefy
瓹	kegn
剈	kejh
噯	kept
嗂	kerm
啋	kesy
噅	keto
哸	kevg
鵑	kewo
嗘	kexd
噴	kfam
呍	kfcy
呿	kfcy
啩	kffh
嘵	kffq
唗	kfhy
呩	kfiy
啚	kflk
嚋	kfnf
嚇	kfoo
哱	kfpb
嚔	kfph
嘋	kftt
咾	kftx
啈	kfuf
噠	kfup
吋	kfy
咞	kgah
哢	kgah
噸	kgbm
咥	kgcf
啨	kgeg
噖	kggn
啞	kghg
噁	kghn
嘕	kgho
吥	kgiy
哶	kgjf
咺	kgjg
唖	kgkg
氀	kgkn
甊	kgkn
鷜	kgko
遱	kgkp
數	kgkt
哣	kgku
婁	kgkv
唡	kgmw
囇	kgmx
啢	kgmy
嘖	kgmy
飸	kgne
鸮	kgng
號	kgnm
咓	kgnn
鴞	kgno
嚽	kgqm
呯	kguh
啑	kgvh
啛	kgvv
嚱	khaa
踐	khaa
噳	khad
囐	khad
噓	khag
嘑	khah
蹛	khah
踖	khaj
躤	khaj
蹃	khak
嚧	khal
跇	khan
踸	khan
踑	khaw
蹣	khay
躪	khay
躡	khbb
踙	khbc
踂	khbn
蹫	khck
踴	khcl
跁	khcn
踆	khct
跍	khdg
蹽	khdi
踳	khdj
踦	khdk
跶	khdp
噦	khdt
蹖	khdv
跀	kheg
跙	kheg
跥	khes
	khf
踋	khfb
踍	khfb
跂	khfc
跱	khff
踛	khff
躊	khff
跿	khfh
跊	khfi
踷	khfj
躂	khfp
蹺	khfq
踜	khft
蹎	khfw
踁	khga
趶	khgf
跮	khgf
踕	khgh
踈	khgi
蹧	khgj
踎	khgk
踾	khgl
貴	khgm
蹟	khgm
遺	khgp
躎	khgq
跠	khgw
躧	khgx
踧	khhc
躩	khhc
躆	khhe
踄	khhi
跕	khhk
跐	khhx
躣	khhy
踃	khie
蹐	khie
蹚	khif
嚬	khim
蹕	khjf
啅	khjh
踶	khjh
踼	khjr
跩	khjx
呫	khkg
踀	khkh
蹪	khkm
蹥	khlp
踻	khmk
蹍	khne
蹘	khne
蹡	khnf
跼	khnk
躃	khnu
趹	khnw
跜	khnx
躍	khny
噛	khob
蹸	khoh
踠	khpb
蹜	khpj
迚	khpk
躥	khpn
踭	khqh
跔	khqk
蹓	khql
哯	khqn
踘	khqo
蹨	khqo
跢	khqq
踲	khrh
躌	khrh
跦	khri
蹏	khrm
躓	khrm
躈	khrt
跅	khry
跴	khsg
蹅	khsg
跒	khsk
蹮	khsn
躚	khsp
跭	khth
蹝	khth
蹤	khth
蹻	khtk
躦	khtm
趷	khtn
踿	khto
鷺	khto
踇	khtu
踒	khtv
跰	khua
踡	khub
躑	khub
蹢	khud
躘	khud
跘	khuf
蹱	khuf
踫	khug
躝	khui
躢	khun
躨	khut
踥	khuv
躙	khuy
蹆	khvp
踚	khwa
嚙	khwb
跉	khwc
蹳	khwc
跈	khwe
跧	khwg
踨	khwh
踰	khwj
跲	khwk
蹌	khwk
趻	khwn
踗	khwn
蹹	khwn
踓	khwy
躖	khxg
蹞	khxm
躀	khxm
喍	khxs
躒	khxs
躟	khye
踤	khyf
躋	khyf
躕	khyf
跓	khyg
趽	khyn
跡	khyo
蹠	khyo
蹾	khyt
蹗	khyx
嘙	kihv
唦	kiit
嗩	kimy
嘡	kipf
嚐	kipj
噹	kipl
咷	kiqn
嗶	kjaf
嚗	kjai
哻	kjfh
呾	kjgg
啺	kjgr
嗢	kjlg
喅	kjug
雖	kjwy
噐	kkak
嚚	kkak
郘	kkbh
唈	kkcn
駡	kkcu
嚻	kkdk
囂	kkdk
嚴	kkdt
卾	kkfb
顎	kkfm
咢	kkfn
鶚	kkfo
遌	kkfp
覨	kkfq
吅	kkg
呺	kkgn
嘍	kkgv
嘳	kkhm
哫	kkhy
戰	kkja
鄲	kkjb
囅	kkje
辴	kkje
單	kkjf
丳	kkjk
鷤	kkjo
鄵	kkkb
碞	kkkd
嘽	kkkf
劋	kkkj
喦	kkkm
嵒	kkkm
氉	kkkn
喿	kkks
獸	kkld
哵	kklj
嘼	kklk
鼉	kklv
	kkmw
嘂	kknk
斝	kkpf
呪	kkqn
遻	kkup
呮	kkwy
喌	kkyh
嘓	klag
嚜	klff
嚸	klfk
呬	klg
噮	klge
囀	klgf
啯	klgy
嚃	klip
嗋	klle
嘪	klmy
嗹	klpy
噣	klqj
啰	klqy
嚺	klup
囉	klxy
噥	kmae
翤	kman
唺	kmaw
鄖	kmbh
吺	kmcy
嘊	kmdf
啱	kmdg
咉	kmdy
嗗	kmeg
呥	kmfg
哃	kmgk
勛	kmln
嚶	kmmv
喎	kmnk
吶	kmty
員	kmu
囎	kmuj
鶰	kmwo
嗺	kmwy
唄	kmy
呡	knan
啒	knbm
噉	knbt
啹	kndg
吳	kndu
吜	knfg
呞	kngk
呉	kngw
喡	knhh
囑	knij
噀	knnw
咇	kntt
嘐	knwe
吷	knwy
嚁	knwy
噿	knyf
呎	knyy
嚉	kogf
嘮	kool
噒	koqh
吙	koy
嗐	kpdk
唍	kpfq
喗	kplh
嚀	kpns
啘	kpqb
哰	kprh
咹	kpvg
啌	kpwa
噾	kpwj
咜	kpxn
呧	kqay
嘫	kqdo
噡	kqdy
嘝	kqef
唃	kqeh
唫	kqg
咰	kqjg
別	kqjh
呴	kqkg
喣	kqko
嚵	kqky
喚	kqmd
嚕	kqoj
哅	kqqb
唙	kqto
呁	kqug
啗	kqvg
喼	kqvn
焁	kqwo
嚠	kqyj
唕	krfh
喤	krgg
啣	krhb
哖	krhf
吽	krhh
嗁	krhm
噑	krif
咮	kriy
嘸	krlo
嚹	krmh
咑	krsh
唞	kruf
呹	krwy
喞	krxb
噭	kryt
喖	ksdg
呠	ksgg
唒	ksgg
嘾	ksjh
槑	ksks
唽	ksrh
喓	ksvg
嘜	kswt
唻	ksww
呏	ktah
咶	ktdg
嘺	ktdk
唀	kten
吀	ktfh
吘	ktfh
哘	ktfh
哠	ktfk
囋	ktfm
喢	ktfv
喠	ktgf
嚑	ktgo
嘷	kthf
喒	kthj
嚊	kthj
唌	kthp
嘚	ktjf
唎	ktjh
呂	ktkf
啝	ktkg
噃	ktol
唩	ktvg
呚	kty
咊	kty
叺	ktyy
啳	kudb
嗴	kudc
唴	kudn
咲	kudy
嚨	kued
呌	kufh
啴	kujf
噇	kujf
噷	kujw
哾	kukq
	kunt
	kunt
嗙	kupy
嚪	kuqv
噂	kusf
嚫	kusq
噺	kusr
喭	kute
嗛	kuvo
唥	kuwc
嗞	kuxx
噚	kvaf
叧	kvb
嘯	kvhh
嚍	kvhl
嗈	kvkc
嘨	kvoj
唚	kvpc
唲	kvqn
吚	kvtt
咃	kwbn
啽	kwga
喩	kwgb
噲	kwgj
嗱	kwgr
噞	kwgw
吤	kwjh
嗰	kwld
嗚	kwno
哬	kwsk
嘦	kwsv
唋	kwty
鳴	kwvo
嘄	kwvs
唂	kwwk
吪	kwxn
喰	kwye
唅	kwyk
嗆	kwyk
嗿	kwym
唸	kwyn
鷕	kwyo
嚩	kxgf
呣	kxgu
咈	kxjh
喲	kxqy
嚛	kxrs
哛	kxwv
噝	kxxi
嘰	kxxt
喥	kyac
嚝	kyaw
啍	kybg
噋	kybt
囄	kyby
噈	kyin
嗃	kymk
呝	kynn
喨	kypm
嚰	kysd
嚤	kysr
嚒	kysx
哴	kyve
嚌	kyvf
嘃	kyvh
唹	kywu
囃	kywy
呟	kyxy
噰	kyxy
呅	kyy
悋	ktuf
鿽	kpwf
劦	lllr
圀	lwye
圐	llye
園	lfky
圝	lyxx
圞	lyxs
甊	lvgy
畮	ltxy
羉	lyxi
軪	lxlt
輚	laay
輨	lphn
輫	lhdd
輱	ldgy
轙	lugy
轡	lxxk
轢	lrxs
黣	lfoy
黬	lfoy
墼	lbmf
軎	lkf
婁	lvf
甊	lvgn
遱	lvpd
氀	lvtn
數	lvty
鷜	lvwo
軾	laag
輚	laat
羈	lafc
羇	lafk
軭	lagg
轞	lahl
羃	lajh
轕	lajn
國	lakg
罭	lakg
爴	laky
轥	lauy
異	lawu
輁	lawy
輙	lbcy
礊	lbmd
繫	lbmi
蟿	lbmj
轚	lbml
罊	lbmm
擊	lbmr
檕	lbms
輒	lbnn
輮	lcbs
罞	lcbt
畷	lccc
罬	lccc
輟	lccc
輽	lcdl
羆	lceo
罷	lcex
圗	lcfd
軽	lcfg
囜	lci
囼	lckd
軩	lckg
圎	lcmi
罵	lcu
畯	lcwt
軛	ldbn
軷	ldcy
軲	ldg
轗	ldgn
輱	ldgt
轊	ldhv
輫	ldjd
盢	ldlf
輭	ldmd
輀	ldmj
罽	ldoj
欭	ldqw
輢	ldsk
轣	ldth
轑	ldui
輳	ldwd
轃	ldwt
軑	ldy
轪	ldy
軚	ldyy
罦	lebf
輣	leeg
罝	legf
圂	lei
慁	lenu
轁	levg
轒	lfam
囩	lfci
圔	lfcl
転	lfcy
轜	lfdj
罣	lfff
罫	lffh
畤	lffy
軒	lfh
団	lfi
畊	lfjh
囲	lfjk
園	lfke
轅	lfke
瞏	lfke
疇	lfnf
黓	lfoa
黭	lfoa
黦	lfob
黲	lfoe
黚	lfof
黫	lfof
點	lfok
黸	lfol
黷	lfom
黗	lfon
黤	lfon
黮	lfon
黕	lfoq
黖	lfoq
黬	lfot
黣	lfou
黰	lfow
黵	lfoy
睪	lfuf
鸅	lfuo
斁	lfut
歝	lfuw
轌	lfvg
轖	lfwk
輘	lfwt
畉	lfwy
軘	lgbn
輊	lgcf
囯	lgd
圑	lgef
輤	lgeg
輔	lgey
軖	lgg
囸	lghd
車	lghh
囨	lgii
團	lgjf
轉	lgjf
睘	lgke
鹮	lgkg
輻	lgkl
翾	lgkn
還	lgkp
疅	lglg
輌	lgmm
輛	lgmy
軏	lgqn
軯	lguh
輕	lgva
輺	lgvl
鑋	lgvq
轤	lhal
軙	lhcy
罒	lhng
輎	lieg
塁	liff
囦	lii
疂	lipg
遝	lipi
輄	liqn
眔	liu
軣	liu
罼	ljaf
畼	ljgr
輰	ljgr
輼	ljlg
辒	ljlg
輵	ljqn
輠	ljsy
輥	ljxx
輯	lkbg
駕	lkcu
罥	lkef
圖	lkfk
甽	lkh
圚	lkhm
毄	lkmc
圓	lkmi
賀	lkmu
乫	lknb
廻	lkpd
迴	lkpd
軦	lkqn
毠	lktn
妿	lkvf
嗧	lkwa
鴐	lkwo
軹	lkwy
畕	llf
圛	llff
轘	llge
劦	lllb
奰	llld
礨	llld
脅	llle
壘	lllf
壨	lllf
畾	lllf
疉	lllg
疊	lllg
纍	llli
轟	lllj
轠	llll
罍	lllm
氎	llln
鸓	lllo
櫐	llls
姭	lllv
罳	llnu
轋	llpy
轀	llwl
圐	llyv
繋	lmci
撃	lmcr
軗	lmcy
圌	lmdj
輲	lmdj
軮	lmdy
畘	lmfg
輖	lmfk
軸	lmg
軕	lmh
買	lmu
輞	lmun
鷶	lmwo
軜	lmwy
軓	lmyy
罠	lnab
輾	lnae
囻	lnav
轏	lnbb
囙	lnd
顋	lndm
罻	lnff
軐	lnfh
翈	lng
圍	lnhh
劜	lnn
軋	lnn
疁	lnwe
轇	lnwe
轛	logf
轐	logy
疄	loqh
轔	loqh
轄	lpdk
畳	lpeg
輐	lpfq
連	lpk
輨	lpnn
軝	lqan
軧	lqay
斀	lqjc
斣	lqjf
劅	lqjj
鸀	lqjo
歜	lqjw
軥	lqkg
輓	lqkq
軳	lqnn
畇	lqug
輡	lqvg
軟	lqwy
輷	lqyg
罶	lqyl
畂	lqyy
畖	lrcy
罛	lrcy
軱	lrcy
磛	lrdf
塹	lrff
輴	lrfh
斬	lrh
覱	lrhq
暫	lrjf
蹔	lrkh
慙	lrnu
鏨	lrqf
槧	lrsu
軼	lrwy
輏	lsgg
甼	lsj
軻	lskg
罧	lssu
轎	ltdk
輈	ltey
辀	ltey
輧	ltff
軠	ltfg
軞	ltfn
畽	ltgf
囷	lti
輹	ltjt
畧	ltkf
輅	ltkg
轓	ltol
軤	ltuh
畮	ltxu
軿	luah
畻	ludf
圏	ludn
轙	lugt
罯	lujf
罿	lujf
図	luqi
較	luqy
輶	lusg
罤	luxt
圕	lvfj
罺	lvjs
轈	lvjs
軺	lvkg
輜	lvlg
軌	lvn
輗	lvqn
輑	lvtk
軔	lvyy
圙	lwdd
軫	lwet
囶	lwfd
軵	lwfy
圇	lwga
輪	lwga
輇	lwgg
輸	lwgj
畍	lwjh
朙	lwme
畟	lwtu
畭	lwty
鴨	lwvo
鴫	lwvo
輍	lwwk
眾	lwwy
囮	lwxv
軨	lwyc
軡	lwyn
罖	lwyu
圀	lwyv
羄	lxhj
羂	lxke
軪	lxln
轢	lxrs
邏	lxwp
羅	lxwy
毘	lxxb
羉	lxyi
圞	lxys
圝	lxyx
轍	lyct
圁	lyd
畩	lyey
罸	lyfu
罜	lygf
軴	lygg
輬	lyiy
辌	lyiy
罰	lyjj
囥	lymv
甿	lynn
軶	lynn
畡	lynw
輆	lynw
轆	lynx
卵	lhng
娮	llb
眾	lwwu
龫	lwfh
龱	lqi
鿂	lwvo
鿡	lxwq
冑	mmff
屴	mlr
屶	mvr
屷	met
岎	mwvt
岰	mxlt
峩	mtry
峸	mdny
崜	mtfg
嵅	mdgy
嵗	mdgy
嶑	mqke
嶬	mugy
嶯	mkby
嶵	mlhd
嶼	mvgw
巙	mutt
幭	mhay
戝	may
朑	muan
朥	muol
甖	mmgy
肦	muwv
胊	muqk
胐	mubm
脁	muqi
脧	muct
膧	muuf
艷	mdhc
豐	mdhu
豒	mdht
豓	mdhl
豔	mdhl
賎	mdny
賤	maay
贓	mdny
贜	mady
髏	melv
巎	mght
鳳	mgwo
嶁	mlvg
賤	maat
農	made
蠈	madj
嵁	madn
賊	madt
贜	madt
巈	mafo
屸	mag
鄷	magb
艶	magc
豑	magt
豊	magu
峫	mahb
刪	majh
嶱	majn
贎	majy
冊	mak
嶇	makk
巏	maky
岠	mang
嵽	maqh
嶜	maqj
戝	mat
峣	matq
覥	mawq
觍	mawq
敟	mawt
邖	mbh
郥	mbh
崡	mbib
貤	mbn
嶐	mbtg
峅	mcah
嵾	mcce
贂	mcce
禸	mci
貽	mckg
賐	mcwt
巁	mday
贆	mddd
峟	mdef
賄	mdeg
賬	mdey
賑	mdfe
峚	mdff
崕	mdff
嵅	mdgt
嵗	mdgt
鳳	mdho
巎	mdht
凮	mdjd
輋	mdlj
剬	mdmj
峏	mdmj
耑	mdmj
顓	mdmm
歂	mdmw
崸	mdmy
頔	mdmy
峸	mdnt
贓	mdnt
屵	mdr
嶏	mdsn
嶚	mdui
嶛	mdui
嶡	mduw
嶥	mduw
賰	mdwj
鴦	mdwo
峽	mdww
嵟	mdwy
賎	mdxy
髒	meaa
嶾	mean
骮	meay
顝	medm
骻	medn
髄	medp
剻	meej
骽	meev
冑	mef
嵈	mefc
嶳	meff
骭	mefh
髐	mefq
岄	meg
骬	megf
髆	megf
岨	megg
骾	megq
骳	mehc
髗	mehl
骴	mehx
髃	mejy
髏	mekv
體	memu
骪	memy
屷	men
髎	mene
髕	mepm
髉	mepy
髖	mepy
骲	meqn
骵	mesg
骿	meua
髊	meua
骹	meuq
髈	meuy
崢	mevh
骩	mevn
骫	mevy
鶻	mewo
嵠	mexd
髇	meyk
骯	meym
髍	meys
岋	meyy
賳	mfak
嶻	mfay
凨	mfci
冃	mfd
冄	mfd
嶿	mfdj
亗	mff
崶	mfff
嶀	mffn
嶢	mffq
嶤	mffq
屽	mfh
巔	mfhm
嵮	mfhw
賕	mfiy
購	mfjf
郮	mfkb
彫	mfke
翢	mfkn
鵰	mfko
週	mfkp
贖	mflm
嶹	mfnf
岏	mfqn
貦	mfqn
崁	mfqw
賭	mftj
財	mftt
峔	mftx
崚	mfwt
崋	mgaf
賦	mgah
峌	mgcf
賻	mgef
崝	mgeg
	mgeg
	mgeg
峬	mgey
鄳	mggb
黽	mggv
岯	mgig
凬	mgjd
峘	mgjg
崠	mgji
崬	mgji
畁	mgjj
峺	mgjq
戙	mgka
敱	mgkc
獃	mgkd
峿	mgkg
剴	mgkj
颽	mgkj
凱	mgkm
顗	mgkm
迵	mgkp
覬	mgkq
敳	mgkt
豈	mgku
嶆	mgmj
甹	mgnb
峛	mgqj
峢	mgqj
屼	mgqn
岼	mguh
崨	mgvh
峓	mgxw
巇	mhaa
帴	mhaa
巘	mhad
巚	mhad
幙	mhad
幪	mhae
幊	mham
幉	mhas
幭	mhat
帺	mhaw
幓	mhce
帊	mhcn
岥	mhcy
貱	mhcy
凪	mhd
帗	mhdc
帪	mhde
帳	mhde
帞	mhdj
幁	mhdm
幍	mhev
幬	mhff
帾	mhfj
幩	mhfm
円	mhgd
峠	mhgh
幘	mhgm
帓	mhgs
幀	mhhm
帩	mhie
幥	mhir
幜	mhji
幆	mhjn
幝	mhkf
岾	mhkg
貼	mhkg
幧	mhks
幗	mhlg
幈	mhna
幃	mhnh
貝	mhny
帵	mhpb
幏	mhpe
幰	mhpn
帎	mhpq
幎	mhpu
峴	mhqn
幨	mhqy
幠	mhro
帄	mhsh
幖	mhsi
幯	mhtb
帲	mhtf
幒	mhtn
帡	mhua
幱	mhui
幟	mhuj
帨	mhuq
帹	mhuv
帿	mhwd
帢	mhwk
帉	mhwv
幮	mhyf
巌	midt
埊	miff
崉	mijg
贘	mipm
汖	miu
巀	miwa
囬	mjdd
廽	mjdp
逥	mjdp
嵵	mjff
崼	mjgh
崵	mjgr
則	mjh
賵	mjhg
赗	mjhg
嵎	mjmy
嵑	mjqn
賜	mjqr
崐	mjxx
崑	mjxx
嶯	mkbt
冋	mkd
嶁	mkgv
賗	mkkh
嵓	mkkk
崿	mkkn
贃	mkkn
巖	mkkt
巗	mkkt
岲	mkqn
貺	mkqn
嶉	mkwy
屴	mlb
嶵	mldd
崓	mldg
嶧	mlff
嵔	mlge
嶃	mlrh
嶄	mlrj
嶩	mmae
賟	mmaw
岟	mmdy
峀	mmf
賙	mmfk
赒	mmfk
峝	mmgk
甖	mmgn
嵦	mmgu
屾	mmh
凧	mmhk
岀	mmj
崱	mmjj
贔	mmmu
赑	mmmu
巊	mmmv
鑍	mmqf
罌	mmrm
嵐	mmtj
贁	mmty
崗	mmum
嬰	mmvf
鸚	mmvo
鸎	mmwo
賏	mmy
譻	mmyf
崫	mnbm
崌	mndg
嶎	mnff
嶈	mnhf
冎	mnmb
剮	mnmj
咼	mnmk
過	mnmp
旤	mnmq
歄	mnmw
乢	mnn
嶍	mnrg
囘	mnv
嵺	mnwe
賿	mnwe
嶪	mogw
嶫	mogw
贌	mogy
巆	mook
嶗	mool
嶸	moos
賧	mooy
廸	mpd
峵	mpdc
賩	mpfi
辿	mpk
賱	mplh
貯	mpsh
峖	mpvg
嵱	mpwk
賝	mpws
岤	mpwy
岮	mpxn
崏	mqaj
嵥	mqas
岻	mqay
貾	mqay
觃	mqbd
岇	mqbj
嵏	mqbt
嵕	mqbt
峗	mqdb
峞	mqdb
嶦	mqdy
贍	mqdy
崅	mqeh
嶰	mqeh
崟	mqf
崯	mqg
飐	mqhk
罓	mqi
賯	mqjb
嶑	mqje
巉	mqky
飔	mqln
翙	mqng
飏	mqnr
羀	mqql
飗	mqql
嵚	mqqw
嶔	mqqw
岉	mqrt
嶽	mqtd
嵧	mqyl
岅	mrcy
販	mrcy
岶	mrg
岴	mrgg
崲	mrgg
岓	mrh
崥	mrtf
嶊	mrwy
嶘	msaa
嵿	msdm
凩	msi
嵖	msjg
贉	msjh
崊	mssy
崍	msww
嵀	msyg
峯	mtdh
嶠	mtdk
岆	mtdy
崻	mtff
峼	mtfk
巑	mtfm
崜	mtgf
貹	mtgg
岝	mthf
岞	mthf
嵲	mths
颰	mtjc
颼	mtjc
颳	mtjd
飇	mtjd
颩	mtje
颵	mtje
飂	mtje
颴	mtjh
颹	mtjh
風	mtji
飃	mtji
飉	mtji
峲	mtjj
颲	mtjj
颾	mtjj
飍	mtjj
颭	mtjk
颱	mtjk
飀	mtjl
飅	mtjl
颮	mtjn
颸	mtjn
颷	mtjo
飈	mtjo
颺	mtjr
颬	mtjt
飋	mtjt
颫	mtjw
颶	mtjw
峉	mtkf
峈	mtkg
賂	mtkg
賉	mtlg
嶶	mtmt
嶓	mtol
貶	mtpy
峩	mtrt
嵙	mtuf
峂	mtuy
崣	mtvf
嵂	mtvh
嵷	mtwh
嵸	mtwh
敗	mty
內	mtyi
賆	muah
嵳	muda
巃	mued
巄	mued
贚	mued
岦	muf
嵄	mugd
嶬	mugt
巙	muht
峷	muj
賠	mukg
嵜	mukh
﨑	mukh
嶒	mulj
贈	mulj
剛	mumj
岡	mumk
崹	muph
嵭	mupy
峧	muqy
賋	muqy
嶟	musf
崷	musg
嵃	mute
嵼	mutg
凲	muvo
嵰	muvo
賺	muvo
賹	muwl
巕	muwv
屶	mvb
峎	mveu
峍	mvfh
贐	mvhl
岧	mvkf
岹	mvkg
崰	mvlg
峮	mvtk
岃	mvyu
屻	mvyy
嵡	mwcn
賒	mwfi
嶼	mwfw
崘	mwga
崙	mwga
峑	mwgf
崄	mwgi
崳	mwgj
峆	mwgk
峇	mwgk
嶖	mwgn
嶮	mwgw
峜	mwhf
峳	mwht
岕	mwjj
冏	mwkd
巋	mwnh
嵨	mwno
嶭	mwnu
賖	mwty
岎	mwvn
嶋	mwvo
嶌	mwvo
鳯	mwvo
鵙	mwvo
酅	mwyb
岺	mwyc
嵢	mwyk
巂	mwyk
賶	mwyk
嶲	mwym
嶺	mwym
岒	mwyn
嶕	mwyo
嶣	mwyo
巓	mxhm
岪	mxjj
嵹	mxkj
岰	mxln
嵶	mxuu
雘	myac
訔	myf
賍	myfg
賘	myfy
峕	myjf
刐	myjh
巐	myma
嵪	mymk
貥	mymn
峐	mynw
賅	mynw
嵉	myps
崺	mytb
崀	myve
嵻	myvi
嵣	myvk
崒	mywf
崪	mywf
賥	mywf
鴅	mywo
屝	nhdd
忇	nlt
怮	nxlt
怴	nany
恌	nqiy
悺	nphn
慽	ndhy
懙	nvgw
懱	naly
翂	nwvt
韤	nhky
戼	nagn
鼊	nkux
屢	nlvd
慺	nlvg
屨	ntlv
憴	nxg
懠	nyjg
恜	naag
悈	naah
愖	nadn
愜	nadw
愅	nafh
羾	nag
恇	nagg
慳	nahf
懢	nahl
敯	najc
慔	najd
昬	najf
刡	najh
愺	najh
蟁	najj
愝	najv
惐	nakg
慬	nakg
慪	nakk
懄	nakl
懽	naky
懜	nalq
懱	nalt
愥	namd
愩	namy
慲	namy
怇	nang
怈	nann
屟	nans
惵	nans
怴	nant
懞	nape
憯	naqj
憽	naqn
睯	nath
暋	natj
敃	naty
壂	nawf
鴖	nawo
臋	naww
恾	nayn
懾	nbbb
憜	nbde
聼	nbfn
邔	nbh
鶌	nbmo
忚	nbn
饏	nbte
忬	ncbh
憰	ncbk
惙	nccc
慘	ncce
悀	nceh
愑	ncel
恈	ncrh
慅	ncyj
墯	ndaf
翇	ndcu
懮	ndet
悵	ndey
屒	ndfe
恗	ndfn
恠	ndhf
懳	ndhn
慽	ndht
屝	ndjd
懨	ndjd
愐	ndmd
愞	ndmd
頨	ndmy
慡	ndqq
憭	ndui
鶋	ndwo
悏	ndww
翜	ndww
忕	ndy
忲	ndyy
懚	nean
愋	nefc
怚	negg
懓	nept
愮	nerm
慆	nevg
慀	nexd
忣	neyy
懴	nfag
憤	nfam
屆	nfbk
厾	nfci
忶	nfcy
翄	nfcy
憢	nffq
忓	nfh
丮	nfhk
屚	nfi
叞	nfic
褽	nfie
犚	nfih
螱	nfij
怽	nfiy
蝨	nfjj
卂	nfk
憉	nfke
懛	nfkf
恄	nfkg
憘	nfkk
懤	nfnf
懗	nfoo
懥	nfph
忨	nfqn
愭	nftj
鷵	nfto
恅	nftx
懎	nfwk
鳵	nfwo
忳	ngbn
恎	ngcf
剭	ngcj
悿	ngdn
愽	ngef
悑	ngey
忹	ngg
卐	nghg
恆	nghg
怌	ngig
慱	ngjf
憓	ngjn
孠	ngkb
愊	ngkl
懶	ngkm
覗	ngkq
慒	ngmj
怲	ngmw
慠	ngqt
屍	ngqx
悽	ngvv
恞	ngxw
懅	nhae
憈	nhag
臦	nhah
臩	nhaj
燛	nhao
郿	nhbh
叏	nhcu
収	nhcy
怶	nhcy
翍	nhcy
	nhd
弉	nhda
奬	nhdd
牂	nhdd
狀	nhdd
獎	nhdd
裝	nhde
墏	nhdf
壯	nhdf
將	nhdf
醬	nhdg
牅	nhdh
漿	nhdi
螿	nhdj
牁	nhdk
牄	nhdk
牆	nhdk
焋	nhdo
銺	nhdq
斨	nhdr
槳	nhds
牀	nhds
牃	nhds
妝	nhdv
娤	nhdv
叚	nhfc
卍	nhgh
疎	nhgi
戄	nhhc
懼	nhhy
疍	nhjg
丩	nhk
郼	nhkb
韕	nhkb
韍	nhkc
韒	nhke
韔	nhke
韛	nhke
韚	nhkf
韝	nhkf
韟	nhkf
韠	nhkf
韡	nhkf
怗	nhkg
韋	nhkh
韣	nhkj
韐	nhkk
韗	nhkl
韞	nhkl
韥	nhkm
韢	nhkn
違	nhkp
韎	nhks
韖	nhks
韘	nhks
韤	nhkt
韜	nhkv
韌	nhky
悓	nhqn
	nhty
舝	nhvh
鶥	nhwo
氹	nii
劚	nilj
屬	nilj
斸	nilr
憆	nipf
戃	nipo
悩	niqb
恌	niqn
遲	nirp
懪	njai
惿	njgh
翨	njgh
愓	njgr
丱	njhg
愰	njiq
愒	njqn
惈	njsy
惃	njxx
悁	nkeg
吢	nkf
悮	nkgd
悜	nkgg
慺	nkgv
屢	nkgv
翀	nkhh
憒	nkhm
憚	nkkf
懆	nkks
愪	nkmy
悞	nknd
怳	nkqn
孹	nkub
礕	nkud
	nkug
幦	nkuh
躄	nkuh
繴	nkui
憵	nkun
糪	nkuo
鷿	nkuo
鸊	nkuo
鼊	nkuv
怾	nkwy
慖	nlag
乪	nld
屇	nld
懌	nlff
怬	nlg
愄	nlge
懁	nlge
恛	nlkg
愶	nlle
恊	nlll
忇	nln
愢	nlny
慩	nlpy
翴	nlpy
慚	nlrh
慍	nlwl
憹	nmae
愲	nmeg
怞	nmg
愷	nmgu
憴	nmgv
屃	nmi
屓	nmi
惻	nmjh
屭	nmmm
凥	nmv
慛	nmwy
忛	nmyy
惽	nnaj
怋	nnan
選	nnap
斲	nngr
巺	nngw
愇	nnhh
屫	nnhk
乚	nnll
乛	nnll
	nnll
	nnll
忋	nnn
繠	nnni
橤	nnns
惢	nnnu
慴	nnrg
怭	nntt
憀	nnwe
鵋	nnwo
憦	nool
惔	nooy
憐	noqh
屪	npdi
迉	npe
悰	npfi
愃	npgg
慏	npju
惲	nplh
翚	nplj
翬	nplj
悺	npnn
懧	npns
愘	nptk
悾	npwa
愹	npwk
惛	nqaj
忯	nqan
怟	nqay
忷	nqbh
惾	nqbt
翪	nqbt
	nqbt
恑	nqdb
恡	nqdc
悕	nqdh
憺	nqdy
惍	nqg
惸	nqjb
怐	nqkg
翑	nqkg
悗	nqkq
愌	nqmd
怉	nqnn
恟	nqqb
恀	nqqy
愡	nqrn
惂	nqvg
	nqvg
忺	nqwy
鸤	nqyg
懰	nqyj
習	nrf
翫	nrfq
憮	nrlo
飁	nrmj
愾	nrno
惞	nrqw
懫	nrrm
怢	nrwy
翐	nrwy
憿	nryt
慓	nsfi
恓	nsg
忊	nsh
杘	nsi
憛	nsjh
憟	nsoy
惏	nssy
慄	nssy
屜	ntan
屧	ntas
邲	ntbh
憍	ntdk
屘	ntfb
屗	ntff
屛	ntff
悎	ntfk
毣	ntfn
慥	ntfp
憡	ntgi
慟	ntgl
覕	nthq
悧	ntjh
慯	ntjr
屨	ntkv
憁	ntln
恦	ntmk
忔	ntnn
憣	ntol
屩	nttk
鴓	ntwo
攺	nty
恲	nuah
惓	nudb
懩	nude
慻	nudh
遅	nudp
憪	nueg
怑	nufh
翋	nug
愔	nujg
慞	nujh
憶	nujn
屖	nuk
層	nulj
遟	nupk
恔	nuqy
愱	nutd
飛	nuth
飝	nuth
翣	nuvf
懻	nuxw
憫	nuyy
憳	nvaf
怓	nvcy
忰	nvfh
翆	nvfj
妀	nvg
惱	nvtq
慃	nwcn
恱	nwcq
鄝	nweb
剹	nwej
勠	nwel
顟	nwem
鷚	nweo
翏	nwer
雡	nwey
憏	nwfi
懙	nwfw
惀	nwga
恮	nwgg
懀	nwgj
憕	nwgu
憸	nwgw
乆	nwi
夬	nwi
刔	nwjh
忦	nwjh
悅	nwkq
翭	nwnd
恘	nwsy
悇	nwty
翂	nwvn
翵	nwvo
鳲	nwvo
懺	nwwg
鴂	nwwo
愯	nwyc
愴	nwyk
懏	nwym
忴	nwyn
鸐	nwyo
慣	nxfm
愼	nxhw
恉	nxjg
怮	nxln
迡	nxpv
懝	nxth
愵	nxuu
悂	nxxf
惤	nxyx
懭	nyaw
惇	nybg
悙	nybh
憞	nybt
乄	nyi
憱	nyin
翞	nyiy
懹	nyke
悋	nykg
懐	nyle
懷	nyle
憻	nylg
懍	nylt
翯	nymk
忼	nymn
惼	nyna
悷	nynd
怺	nyni
懡	nysc
戂	nysd
悢	nyve
懠	nyvf
慉	nyxl
怰	nyxy
忟	nyy
灱	ovt
炄	onhf
烑	oqiy
烸	otxy
煘	odgy
燨	ougy
爍	orxs
爔	ougy
甇	oopy
甐	oqay
粈	onhf
糭	oobt
熡	olvg
熽	ovfj
烒	oaag
煁	oadn
糂	oadn
燍	oadr
粸	oadw
糤	oaet
粓	oafg
煂	oafh
灴	oag
燁	oagf
熞	oahf
烥	oahh
爁	oahl
糮	oahl
爦	oahq
灷	oaj
糢	oajd
焟	oajg
爡	oajj
燤	oajy
熰	oakk
熯	oakw
爟	oaky
煐	oamd
焫	oamw
熿	oamw
熕	oamy
糚	oanf
粔	oang
煠	oans
熸	oaqj
糣	oaqj
燪	oaqn
烵	oaqy
糒	oate
爤	oaui
糷	oaui
爑	oawo
烡	oawu
糀	oawx
粠	oawy
邩	obh
炪	obmh
灺	obn
燏	ocbk
煣	ocbs
糝	occe
熥	ocep
炲	ockg
焌	ocwt
糔	ocyj
爄	oday
糲	oday
炦	odcy
類	oddm
烠	odeg
粻	odey
煃	odff
煘	odgt
炐	odhh
糎	odjf
粨	odjg
煗	odmd
糆	odmd
粫	odmj
糥	odmj
煩	odmy
頪	odmy
烣	odoy
爏	odth
粀	odyy
粏	odyy
烰	oebg
粰	oebg
焩	oeeg
煖	oefc
燰	oept
熎	oerm
熖	oevg
烼	oey
燌	ofam
焼	ofaq
熆	ofcl
燸	ofdj
烓	offg
燒	offq
籵	ofh
煹	ofjf
熺	ofkk
糦	ofkk
爧	ofkw
煵	ofmf
燽	ofnf
爀	ofoo
焃	ofoy
粩	oftx
燵	ofup
燯	ofwc
籿	ofy
煿	ogef
糐	ogef
烳	ogey
炡	oghg
炋	ogiy
烜	ogjg
煏	ogkl
煉	ogli
粖	ogsy
鄴	ogub
叢	oguc
丵	oguf
對	oguf
懟	ogun
糳	oguo
鸈	oguo
鑿	oguq
黺	oguv
業	oguw
菐	oguy
烴	ogva
彂	ogxd
爐	ohal
爈	ohan
爠	ohhy
炶	ohkg
爘	ohqe
粯	ohqn
燦	ohqo
焇	oieg
糛	oipf
爣	oipo
烑	oiqn
粆	oitt
熦	oiwy
熚	ojaf
爗	ojaf
熶	ojbc
焨	ojeg
粴	ojfg
糧	ojgf
炟	ojgg
煶	ojgh
煬	ojgr
糃	ojgr
灲	ojh
熀	ojiq
焻	ojjg
爞	ojjj
煴	ojlg
焬	ojqr
粿	ojsy
焺	ojta
煋	ojtg
燳	ojvo
焜	ojxx
燝	ojyi
焆	okeg
熡	okgv
燀	okkf
焒	okkg
煰	okkk
熉	okmy
炾	okqn
熼	olaw
糞	olaw
煾	oldn
煟	oleg
畨	olf
燡	olff
爅	olff
糬	olfj
畑	olg
糫	olge
糰	olgf
炠	olh
熁	olle
燲	ollm
燭	olqj
焑	olsy
熅	olwl
燶	omae
粬	omag
炈	omcy
煓	omdj
炴	omdy
粙	omg
烔	omgk
粡	omgk
熴	omjx
粣	ommg
籶	omn
煱	omnk
煈	omtj
焵	omum
焹	omun
烱	omwk
熣	omwy
烿	omye
煀	onbm
炄	onfg
粈	onfg
籸	onfh
煆	onhc
煝	onhg
煒	onhh
糏	onie
爥	onij
熤	onug
熮	onwe
燿	onwy
粎	onyy
顃	oodm
烾	ooff
爜	oogc
敥	oohc
煔	oohk
覢	oohq
飊	oooj
燚	oooo
燊	ooos
爃	ooos
歘	ooow
	oopb
膋	oope
褮	oope
塋	oopf
煢	oopf
醟	oopg
犖	ooph
滎	oopi
禜	oopi
縈	oopi
螢	oopj
營	oopk
勞	oopl
嵤	oopm
焭	oopm
罃	oopm
憥	oopn
甇	oopn
熒	oopo
鶯	oopo
覮	oopq
鎣	oopq
榮	oops
檾	oops
嫈	oopv
瑩	oopy
謍	oopy
燐	ooqh
欻	ooqw
鶑	oowo
炏	ooy
顲	ooym
爎	opdi
糘	opey
熐	opju
熍	opkk
煇	oplh
焥	opqb
烢	opta
焢	opwa
焪	opwx
炨	opxn
鄰	oqab
粦	oqah
焝	oqaj
亃	oqan
甐	oqan
翷	oqan
斴	oqar
灮	oqb
煼	oqbt
糉	oqbt
焔	oqhj
煥	oqmd
糭	oqot
粷	oqoy
粅	oqrt
炍	orcy
粄	orcy
炘	orh
熂	orno
焮	orqw
焷	ortf
粺	ortf
燩	oryt
煙	osfg
熛	osfi
烞	oshy
燂	osjh
炣	oskg
爩	osre
炑	osy
炢	osyy
灹	otan
籷	otan
炧	otbn
粚	otbn
燆	otdk
熢	otdp
烐	otey
烆	otfh
粁	otfh
焅	otfk
粍	otfn
烶	otfp
烍	otfq
煄	otgf
燻	otgo
爋	otgo
烻	othp
烅	otlg
熜	otln
炿	otmy
籺	otnn
煍	otoy
熪	otqq
炵	otuy
烸	otxu
炇	oty
秌	oty
熾	ouaj
烪	oudy
爖	oued
燗	oueg
糋	ouej
煫	ouey
炓	oufh
爛	ougi
燨	ougt
爔	ougt
燑	oujf
燱	oujn
糡	oujq
熷	oulj
燜	ouny
爓	ouqv
烄	ouqy
燇	ousf
煪	ousg
熑	ouvo
熌	ouwy
焍	ouxt
燘	ouyy
燬	ovac
燖	ovaf
粋	ovfh
煡	ovfp
籹	ovg
熽	ovhh
燼	ovhl
粶	oviy
炤	ovkg
爉	ovln
灱	ovn
籾	ovyy
焧	owcn
炂	owcy
爚	owga
烇	owgg
燴	owgj
糩	owgj
烚	owgk
粭	owgk
熻	owgn
燈	owgu
炌	owjh
熓	owno
烌	owsy
焀	owwk
炛	owxb
炩	owyc
焳	owyg
熗	owyk
焾	owyn
燋	owyo
粌	oxhh
纇	oxim
颣	oxim
炥	oxjh
爍	oxrs
糑	oxuu
粃	oxxn
煯	oxxr
熫	oyao
爌	oyaw
焞	oybg
燉	oybt
焴	oyce
粧	oyfg
炞	oyhy
爙	oyke
燷	oyli
燣	oylt
熇	oymk
粇	oymn
燺	oyms
糄	oyna
熩	oync
爊	oyno
粐	oynt
烗	oynw
熝	oynx
麊	oynx
爕	oyoo
夑	oyot
煷	oypm
燫	oyuo
烺	oyve
煻	oyvk
焿	oyvw
焠	oywf
焲	oywy
炆	oyy
熂	oooo
龦	oiph
龽	oqoy
冡	pfeu
宨	pqiu
宬	pdny
寷	pmdu
悹	phnn
瓭	pqgy
礽	pyet
祊	pyyt
禨	pyxy
窚	pwdy
裶	puhd
襪	puay
襷	puvr
鼆	pjux
寠	plvf
裫	pujg
褸	pulv
竈	pwfx
窶	pwlv
窗	pwtt
袪	pufc
宧	pahh
寛	pahq
寬	pahy
冪	pajh
冣	pbcu
宻	pcum
翝	pdcn
鶷	pdho
寷	pdhu
寕	pdls
宬	pdnt
宊	pdu
実	pdwu
肎	pef
冝	pegf
寀	pesu
寪	peto
寘	pfhw
崈	pfim
賨	pfim
鶎	pfio
寋	pfjb
騫	pfjc
宑	pfjj
賽	pfjm
鶱	pfjo
弿	pfjx
冦	pfqc
鵍	pfqo
宼	pfqv
宯	pftb
寈	pgef
冡	pgeu
顁	pghm
賓	pgim
顮	pgim
寭	pgjn
翧	pgjn
冨	pgkl
憲	pgln
戭	pgma
寳	pgqm
寚	pgrm
寶	pgrm
寁	pgvh
寊	phmu
宐	phng
鼏	phnn
宨	piqb
寖	pivc
寔	pjgh
鄍	pjub
覭	pjuq
鼆	pjuv
宺	pkgq
寠	pkgv
宲	pksu
宮	pktk
鄆	plbh
顐	pldm
皸	plhc
軍	plj
運	plpk
鶤	plwo
宂	pmb
冚	pmj
鴧	pmwo
寢	pnhc
悹	pnhn
寱	pnhs
寎	pnhw
寣	pnhy
寍	pnlf
寜	pnlh
鸋	pnlo
寧	pnls
賔	pnmu
寗	pntf
叜	pocu
冞	pou
宩	pou
	pqb
鹓	pqbg
邥	pqbh
惌	pqbn
鵷	pqbo
瓭	pqgn
沊	pqii
寃	pqky
寏	pqmd
冘	pqv
鴆	pqwo
寙	prcy
冟	prxb
宎	ptdu
宒	ptfn
額	ptkm
愙	ptkn
審	ptol
覾	ptoq
宷	ptou
裓	puaa
襼	puac
襽	puai
襺	puaj
襤	pual
袣	puan
褋	puas
襪	puat
褗	puav
褀	puaw
襔	puay
襵	pubb
袦	pubm
衪	pubn
襂	puce
褬	pucs
褦	pucx
袏	puda
袸	pudb
袚	pudc
裶	pudd
褉	pudd
裖	pude
袥	pudg
袹	pudj
袻	pudj
襫	pudj
裿	pudk
袴	pudn
裺	pudn
裌	pudw
褑	puec
寵	pued
衱	puey
衼	pufc
褤	pufe
袿	puff
褠	puff
衦	pufh
袆	pufh
袺	pufk
襩	pufm
襭	pufm
襓	pufq
裬	puft
衭	pufw
襶	pufw
褹	pufy
衧	pugf
襋	pugi
褿	pugj
褔	pugl
襀	pugm
襰	pugm
襧	pugq
裋	pugu
褄	pugv
襹	pugx
補	pugy
裲	pugy
褃	puhe
裃	puhh
袩	puhk
裭	puhm
褝	puif
襠	puil
襊	pujc
裡	pujf
襅	pujf
衵	pujg
褆	pujh
襮	puji
裮	pujj
褞	pujl
褟	pujn
裩	pujx
裐	puke
襌	pukf
衶	pukh
	pukm
	pukm
襙	puks
褸	pukv
裀	puld
襗	pulf
襡	pulj
褳	pulp
裍	puls
襬	pulx
襛	pume
衻	pumf
袡	pumf
褍	pumj
裯	pumk
袇	pumy
褘	punh
袐	punt
襈	punw
袯	puny
襨	puof
裧	puoo
襆	puoy
褣	pupk
裈	pupl
褌	pupl
衴	pupq
袕	pupw
袉	pupx
衹	puqa
襐	puqe
袧	puqk
裪	puqm
袳	puqq
袀	puqu
袛	puqy
襜	puqy
袙	purg
袾	puri
袟	purw
褾	pusi
袔	pusk
褼	pusn
寴	pusq
袘	putb
襖	putd
褈	putf
袶	puth
裄	puth
裫	puth
褷	puth
袮	puti
襣	putj
裇	putl
襎	putl
襸	putm
裑	putt
複	putt
宍	puu
褨	puua
裷	puub
襱	puud
襉	puue
褅	puuh
襕	puui
襴	puui
襇	puuj
襚	puup
裞	puuq
襯	puuq
襒	puut
襑	puvf
袑	puvk
袽	puvk
衳	puwc
袊	puwc
襏	puwc
袗	puwe
袝	puwf
袵	puwf
襳	puwg
衸	puwj
褕	puwj
襘	puwj
襷	puwr
襍	puws
衯	puwv
襝	puww
襥	puwy
褖	puxe
袎	puxl
褵	puyc
襢	puyg
褯	puyh
褲	puyl
裗	puyq
袨	puyx
鞌	pvaf
頞	pvdm
冩	pvqo
寫	pvqo
宭	pvtk
鴳	pvwo
窢	pwag
鵼	pwao
窷	pwbb
窋	pwbm
窡	pwcc
窓	pwcn
梥	pwcs
窫	pwdd
竂	pwdi
鶟	pwdo
窚	pwdt
窰	pwem
窙	pwfb
窐	pwff
穽	pwfj
竇	pwfm
竃	pwfn
窺	pwfq
窛	pwfv
竈	pwfv
窴	pwfw
窾	pwfw
穻	pwgf
竀	pwgq
窉	pwgw
窅	pwhf
窧	pwhj
窏	pwif
窪	pwif
窤	pwjx
窶	pwkv
窩	pwmk
穵	pwnb
窹	pwnk
窲	pwof
窌	pwqb
窎	pwqg
窇	pwqn
窞	pwqv
窂	pwrh
竅	pwrt
窊	pwry
穼	pwsu
罙	pwsu
竊	pwtc
穾	pwtd
宱	pwtf
竆	pwtk
窸	pwtn
窻	pwtn
竁	pwtn
窮	pwtx
竉	pwud
窯	pwuo
窔	pwuq
寑	pwvc
竄	pwvn
窼	pwvs
彮	pwwe
窵	pwwo
鴪	pwwo
窱	pwws
窽	pwxw
隺	pwyd
寉	pwyf
窣	pwyf
寯	pwym
鶴	pwyo
宆	pxb
宖	pxcu
實	pxfm
迱	pxpv
寲	pxth
祴	pyaa
禥	pyaf
禖	pyas
祂	pybn
祃	pycg
禡	pycy
祳	pyde
祏	pydg
祐	pydk
禲	pydy
禐	pyec
礽	pyen
禱	pyff
祎	pyfh
禃	pyfh
祙	pyfi
祮	pyfk
祾	pyft
禛	pyfw
宔	pygf
祬	pygf
禣	pygf
禰	pygq
禎	pyhm
視	pyhq
禔	pyjh
禵	pyjm
禢	pyjn
禓	pyjr
祼	pyjs
禑	pyjy
祦	pykd
禪	pykf
祌	pykh
祻	pyld
禗	pyln
禤	pyln
祵	pyls
禝	pylt
禩	pylw
祋	pymc
禯	pyme
禂	pymk
禍	pymk
禮	pymu
祤	pyng
禕	pynh
祕	pynt
禷	pyom
禈	pypl
祇	pyqa
祪	pyqb
祹	pyqm
礿	pyqy
禆	pyrf
祩	pyri
禠	pyrm
祑	pyrw
禋	pysf
禫	pysj
祅	pytd
祣	pyte
祍	pytf
祰	pytk
禶	pytm
禙	pyue
禉	pyug
禘	pyuh
禭	pyup
祱	pyuq
祶	pyut
禌	pyux
祲	pyvc
祒	pyvk
禴	pywa
祔	pywf
祄	pywj
禬	pywj
祫	pywk
禒	pyxe
祿	pyxi
禨	pyxt
祽	pyyf
禞	pyyk
禟	pyyk
祊	pyyn
袓	pueg
寧	pgng
盁	pyfg
迎	pyfg
酿	pfiu
鿅	pyfb
鿆	pydc
鿋	pufk
鿥	pbgq
勨	qkel
狘	qtay
狣	qtqi
狦	qtmf
猅	qthd
獩	qthy
瓻	qdmy
甔	qdwy
覜	qihq
觔	qelt
觻	qers
釖	qvt
釛	qlt
釢	qet
鈁	qyt
鈕	qnhf
鈖	qwvt
鈛	qay
鈻	qhnn
鉞	qany
鉧	qxyy
銊	qdgy
銚	qqiy
銭	qdny
銹	qtet
鋂	qtxy
鋨	qtry
鋮	qdny
錘	qtfg
錢	qaay
錧	qphn
錺	qayt
鍼	qdgy
鏚	qdhy
鐂	qgjl
鐌	qqke
鐖	qxxy
鐬	qhdy
鑁	qobt
鑖	qaly
鑠	qrxs
鑶	qady
頫	qidm
魛	qovt
魴	qoyt
鮡	qoqi
鯎	qody
鯡	qohd
鰄	qody
鰔	qody
鱥	qohy
鱮	qovw
鱳	qors
鱴	qoay
鱵	qoty
鱽	qgvt
鴵	qiwo
錏	qgfg
鐚	qgfn
鑡	qhbh
鏤	qlvg
鱐	qovj
鱦	qoxg
鱭	qoyj
獿	qtgt
鏽	qvfj
鑇	qyjg
鉽	qaag
鐷	qaas
錢	qaat
鍩	qadk
頯	qadm
鍖	qadn
鐁	qadr
鑶	qadt
錤	qadw
鏾	qaet
鉗	qafg
氒	qafj
鐯	qafj
	qafj
鑉	qafl
釭	qag
鏵	qagf
鋣	qahb
鏗	qahf
鑑	qahl
鑦	qahm
鑬	qahq
釾	qaht
	qaht
鑮	qaif
銾	qaiy
鏌	qajd
錯	qajg
鉕	qakg
鏂	qakk
鑎	qakm
鑵	qaky
錨	qalg
鑖	qalt
鍈	qamd
锳	qamd
帋	qamh
鉔	qamh
鐄	qamw
鏋	qamy
鉅	qang
鉪	qann
鍱	qans
鉞	qant
鋱	qany
鐕	qaqj
銰	qaqy
鈛	qat
鑝	qatp
钄	qaui
鍣	qavk
鑊	qawc
匒	qawk
鎝	qawk
錵	qawx
鉷	qawy
釴	qay
鋩	qayn
錺	qayn
铓	qayn
鴟	qayo
鑷	qbbb
鎁	qbbh
駌	qbcu
鋷	qbcy
釨	qbg
鉺	qbg
卬	qbh
夘	qbh
邜	qbh
釕	qbh
鐊	qbjr
盌	qblf
錳	qblg
鈯	qbmh
夗	qbn
釶	qbn
銸	qbnn
兇	qbqb
錒	qbsk
鄒	qbtb
皺	qbtc
鶵	qbto
芻	qbtt
雛	qbty
妴	qbvf
鴛	qbwo
鐍	qcbk
鍒	qcbs
錣	qccc
鏒	qcce
鎟	qccs
銿	qceh
鈶	qckg
鈀	qcn
鈗	qcqn
鉾	qcrh
鋑	qcwt
鎷	qcy
釵	qcyy
頠	qdbm
鈪	qdbn
敎	qdbt
鈜	qdcy
鈸	qdcy
郩	qdeb
殽	qdec
銪	qdeg
鍸	qdeg
鋹	qdey
錛	qdfa
鋠	qdfe
鍷	qdff
鎒	qdff
錼	qdfi
銙	qdfn
鈷	qdg
鉐	qdg
銊	qdgt
鍼	qdgt
銌	qdhb
鍥	qdhd
鏚	qdht
鏏	qdhv
銇	qdiy
銆	qdjg
匎	qdjn
鈽	qdmh
瓻	qdmn
鵗	qdmo
顉	qdmy
鋮	qdnt
鋴	qdqn
鏯	qdqq
厃	qdr
錡	qdsk
锜	qdsk
矦	qdtd
鋳	qdtf
鐐	qdui
鐝	qduw
甔	qdwn
鋏	qdww
銭	qdxy
釱	qdy
鈦	qdyy
觨	qeai
觾	qeao
觵	qeaw
鋢	qebg
觭	qedk
錋	qeeg
觙	qeey
鍰	qefc
觟	qeff
觩	qefy
鋝	qefy
鈅	qeg
鉏	qegg
鋤	qegl
觘	qeit
觛	qejg
觶	qekf
觸	qelj
觔	qeln
觿	qemk
觽	qemm
釢	qen
觓	qenh
鑀	qept
觗	qeqa
觤	qeqb
觼	qeqt
觝	qeqy
鎐	qerm
釤	qet
觡	qetk
觧	qeud
觪	qeuh
觲	qeuh
鋖	qevg
觮	qevi
觬	qevq
觹	qewm
鵤	qewo
觻	qexs
鈒	qeyy
钑	qeyy
鐵	qfag
鐼	qfam
鐡	qfau
鎑	qfcl
鈘	qfcy
鉣	qfcy
勻	qfd
鑐	qfdj
銈	qffg
鐃	qffq
釷	qfg
針	qfh
釬	qfh
鎮	qfhw
銢	qfiy
銶	qfiy
鎱	qfke
銡	qfkg
鐳	qflg
鑟	qflm
鑄	qfnf
釫	qfnn
鋕	qfny
鋍	qfpb
鎍	qfpi
鈨	qfqn
﨧	qftb
銒	qftf
鍺	qftj
銬	qftn
釮	qftt
銠	qftx
﨨	qfuf
鐽	qfup
錴	qfwf
鐟	qfwj
鑚	qfwm
錂	qfwt
鈇	qfwy
鳠	qgac
鈃	qgah
錻	qgah
钘	qgah
鉶	qgaj
铏	qgaj
鐂	qgal
鲯	qgaw
鈍	qgbn
鲬	qgce
鲹	qgce
銍	qgcf
铚	qgcf
鲃	qgcn
	qgdj
鳡	qgdn
鎛	qgef
镈	qgef
錆	qgeg
鋪	qgey
錶	qgey
釪	qgfh
鲓	qgfn
錱	qggf
鲾	qggl
鲀	qggn
鲏	qghc
鉦	qghg
錏	qghg
鈣	qghn
鐚	qghn
鲿	qgic
銔	qgif
鉟	qgig
鈈	qgiy
鏄	qgjf
鳀	qgjh
錬	qgji
鳁	qgjl
鏸	qgjn
鋙	qgkg
铻	qgkg
鎘	qgkh
鋉	qgki
鑩	qgkk
鍢	qgkl
鋀	qgku
鏉	qgkw
鳂	qgle
鍊	qgli
鲉	qgmg
鏪	qgmj
鲗	qgmj
鲖	qgmk
鈵	qgmw
鳚	qgnf
鱾	qgnn
鳛	qgnr
鋄	qgoc
铔	qgog
錽	qgot
	qgqb
鲌	qgrg
鳈	qgri
鲘	qgrk
鲄	qgsk
鲊	qgtf
鳤	qgtn
鳉	qguf
	qgug
匉	qguh
鳒	qguo
鳑	qguy
鋞	qgva
鲪	qgvk
鍿	qgvl
鱽	qgvn
鲙	qgwc
鑈	qgwq
銕	qgxw
鳣	qgyg
鈺	qgyy
钀	qhad
鐻	qhae
鏬	qhah
鐪	qhal
鑪	qhal
錿	qham
鑢	qhan
鎼	qhar
鈙	qhcy
鈹	qhcy
鐬	qhdt
錹	qheg
鉬	qhg
钁	qhhc
	qhhc
鉲	qhhy
鑺	qhhy
亇	qhj
鋽	qhjh
鉆	qhkg
夞	qhkx
鏀	qhlo
鍞	qhmy
鐤	qhnn
迯	qhpi
鋧	qhqn
鑡	qhwb
釙	qhy
銷	qieg
鍅	qifc
覙	qihq
錔	qijg
鐋	qijr
鋿	qimk
鎖	qimy
鏜	qipf
鏛	qiph
鐺	qipl
鑜	qipm
钂	qipo
鎲	qipq
镋	qipq
鐣	qipr
鏿	qips
銚	qiqn
銧	qiqn
鎃	qire
鈔	qitt
淾	qiu
釥	qiy
鏎	qjaf
鑤	qjai
勨	qjel
鋰	qjfg
銲	qjfh
鈤	qjg
鍀	qjgf
鉭	qjgg
鍉	qjgh
鍚	qjgr
釗	qjh
鉮	qjhh
鎤	qjiq
錩	qjjg
锠	qjjg
亀	qjjn
鏝	qjlc
鎾	qjlg
鍝	qjmy
鎉	qjng
迿	qjpd
銞	qjqf
鍻	qjqn
錫	qjqr
錁	qjsy
鍟	qjtg
錕	qjxx
鉵	qjy
鐛	qjyi
鍓	qkbg
邭	qkbh
鋗	qkeg
釦	qkg
鋘	qkgd
鋥	qkgg
鏤	qkgv
釧	qkh
鈡	qkhh
鏴	qkhk
鐀	qkhm
鑓	qkhp
鋜	qkhy
鋁	qkkg
鋛	qkkh
鍔	qkkn
鐰	qkks
銱	qkmh
鵵	qkqo
欨	qkqw
鉂	qkqy
斪	qkrh
敂	qkty
鴝	qkwo
鉙	qkwy
雊	qkwy
酁	qkxb
劖	qkxj
毚	qkxy
錮	qldg
銦	qldy
鐸	qlff
鈿	qlg
鍡	qlge
鐶	qlge
镮	qlge
鎠	qlgh
鉀	qlh
鉫	qlkg
鑸	qllf
鑘	qlll
釛	qln
錷	qlnn
鍶	qlny
鏈	qlpy
鐲	qlqj
鏩	qlrh
鎅	qlwj
鏍	qlxi
鑼	qlxy
錪	qmaw
鈠	qmcy
錌	qmdf
鍴	qmdj
鉠	qmdy
鏰	qmee
镚	qmee
觰	qmfj
錭	qmfk
觴	qmfr
鈾	qmg
銅	qmgk
鎧	qmgu
鍘	qmjh
鉛	qmkg
銏	qmmg
銟	qmmh
釠	qmn
鍋	qmnk
鐹	qmnp
鎽	qmth
負	qmu
鋼	qmum
奐	qmwd
鑴	qmwk
烉	qmwo
夐	qmwt
敻	qmwt
鈉	qmwy
鏙	qmwy
鋇	qmy
釩	qmyy
鍲	qnaj
鈱	qnan
饳	qnbm
馂	qnct
鋸	qndg
鈕	qnfg
馌	qnfl
馎	qngf
鉰	qngk
饾	qngu
鍜	qnhc
鏘	qnhf
鎇	qnhg
鍏	qnhh
鈻	qnhn
钃	qnij
馃	qnjs
鐴	qnku
馉	qnme
釓	qnn
釔	qnn
釲	qnn
鋦	qnnk
鐉	qnnw
炰	qnou
钖	qnrt
饤	qnsh
饦	qnta
饹	qntk
鉍	qntt
	qnty
鏐	qnwe
镠	qnwe
饸	qnwk
鈌	qnwy
鑃	qnwy
鈮	qnxn
鈊	qny
饻	qnye
鉯	qnyw
鈬	qnyy
鱯	qoac
魽	qoaf
鰹	qoaf
魟	qoag
鰙	qoak
鰸	qoak
鰳	qoal
鮔	qoan
鰈	qoas
鱴	qoat
鰋	qoav
鯕	qoaw
鱑	qoaw
鱹	qoay
鯫	qobc
鯭	qobl
鮿	qobn
魣	qocb
鯒	qoce
鯵	qoce
鰺	qoce
鰠	qocj
鮐	qock
鱊	qock
鰇	qocs
鮻	qoct
鰢	qocy
鮁	qodc
鯡	qodd
鮪	qode
鰖	qode
鰗	qode
鮕	qodg
鮖	qodg
爒	qodi
鮞	qodj
鰆	qodj
魷	qodn
鮬	qodn
鱤	qodn
鯎	qodt
鰄	qodt
鰔	qodt
鱖	qodw
鱱	qody
鰀	qoec
鰩	qoem
鱁	qoep
鱫	qoet
鮾	qoev
魥	qoey
魼	qofc
鮭	qoff
鯥	qoff
鯐	qofh
鮇	qofi
鯺	qofj
鰭	qofj
鱬	qofj
鮚	qofk
鱚	qofk
鰪	qofl
鱩	qofl
鱝	qofm
鮳	qofn
魭	qofq
鱙	qofq
鯪	qoft
鱈	qofv
鮱	qofx
鯄	qofy
鯖	qoge
鑆	qogf
鱄	qogf
魱	qogg
魾	qogg
魳	qogh
鮃	qogh
鯟	qogi
鰊	qogi
鯻	qogj
鰽	qogj
鯃	qogk
鱷	qogk
鰏	qogl
鰿	qogm
魨	qogn
鯁	qogq
鮧	qogw
鱺	qogx
鏷	qogy
鯆	qogy
鮍	qohc
鱋	qohg
鮛	qohi
鮎	qohk
鱸	qohl
鯱	qohm
鱥	qoht
鰬	qohy
匊	qoi
灳	qoi
鮹	qoie
鱨	qoij
鮡	qoiq
魦	qoit
鯋	qoit
鰻	qojc
魯	qojf
鯉	qojf
鰣	qojf
鯹	qojg
魝	qojh
鯷	qojh
鯧	qojj
鱪	qojj
鰛	qojl
鰨	qojn
鯣	qojr
鰑	qojr
鯤	qojx
鰅	qojy
鱓	qokf
鰐	qokn
鱢	qoks
鯝	qold
鰃	qole
鱞	qole
魻	qolh
鰥	qoli
鱰	qolj
鮰	qolk
鰮	qoll
鰓	qoln
鰱	qolp
鮂	qolw
鱡	qomd
鮋	qomg
鰂	qomj
鮦	qomk
鯛	qomk
鰴	qomt
鱧	qomu
鱦	qomv
魶	qomw
鰕	qonc
鱂	qonf
鮙	qong
鯴	qonj
魢	qonn
鰼	qonr
鮅	qont
鱗	qooh
鐒	qool
鑅	qoos
錟	qooy
鰘	qopf
鰚	qopg
鰰	qoph
鯮	qopi
鰫	qopk
鯶	qopl
魫	qopq
鯇	qopq
鮟	qopv
鮀	qopx
鮠	qoqb
鮣	qoqb
鱌	qoqe
鏻	qoqh
鯑	qoqh
鮈	qoqk
鰡	qoql
鮑	qoqn
鱻	qoqo
鮸	qoqq
魩	qoqr
鯼	qoqt
魡	qoqy
魬	qorc
鮊	qorg
鰉	qorg
鮢	qori
鰁	qori
鯯	qorj
鮜	qork
鯂	qosg
鰾	qosi
鱏	qosj
魺	qosk
鯠	qosw
魠	qota
鯚	qotb
鮓	qotf
鮏	qotg
鯀	qoti
鯏	qotj
鮥	qotk
鯌	qotk
鯦	qotk
鱎	qotk
鱕	qotl
魸	qotn
魹	qotn
鰍	qoto
鯅	qotp
鯓	qott
鰒	qott
鱵	qott
鮗	qotu
鯘	qotv
穌	qoty
魞	qoty
魚	qou
鮩	qoua
鮮	qoud
鱶	qoue
鱃	qouf
鱒	qouf
鰌	qoug
鱆	qouj
鱛	qouj
鱔	qouk
鰜	qouo
鮫	qouq
鮵	qouq
鮷	qout
鯜	qouv
鰦	qoux
鰟	qouy
鯽	qovb
鮼	qovc
鱘	qovf
鯞	qovh
鱐	qovh
鮉	qovk
鮶	qovk
鯔	qovl
魛	qovn
鱲	qovn
鰎	qovp
鯢	qovq
鮘	qowa
鯩	qowa
魿	qowc
鱍	qowc
鮲	qowd
鯸	qowd
鮒	qowf
鰤	qowh
鰶	qowi
魪	qowj
鱠	qowj
鮯	qowk
鯰	qown
鰞	qowo
鵴	qowo
鷠	qowo
鯾	qowq
鮴	qows
鰷	qows
鮽	qowt
魵	qowv
鱮	qoww
魤	qowx
魜	qowy
鱜	qoxb
鮄	qoxj
鮨	qoxj
鱳	qoxs
鰯	qoxu
魮	qoxx
鈥	qoy
銤	qoy
鯿	qoya
鯙	qoyb
鱭	qoyf
鱣	qoyg
鱅	qoyh
鯨	qoyi
鱇	qoyi
鰝	qoyk
魧	qoym
魲	qoyn
魴	qoyn
鯍	qoyq
鯲	qoyu
鮌	qoyx
魰	qoyy
鯳	qoyy
鑧	qpay
鋐	qpdc
鎋	qpdk
鎵	qpey
鑳	qpfh
錝	qpfi
鋎	qpfq
鍹	qpgg
錠	qpgh
鑌	qpgm
鏔	qpgw
鍕	qplh
錧	qpnn
鑏	qpns
鋺	qpqb
鈂	qpqn
銨	qpvg
鑔	qpwi
鏥	qpwj
鑹	qpwn
鉈	qpxn
鎺	qpyg
銽	qqak
胷	qqbe
卶	qqbh
鍐	qqbt
銫	qqcn
鈎	qqcy
爼	qqeg
夡	qqfk
鍂	qqg
匁	qqi
匇	qqi
鉨	qqiy
鐌	qqje
銁	qqjg
鉤	qqkg
銘	qqkg
鋔	qqkq
鑱	qqky
镵	qqky
翗	qqng
鉋	qqnn
铇	qqnn
鑥	qqoj
鑁	qqot
迻	qqpi
夠	qqqk
鉹	qqqy
鋾	qqrm
鍃	qqrn
鍯	qqrn
鎩	qqsc
鉚	qqtb
鈞	qqug
憌	qqun
郺	qqvc
錎	qqvg
錚	qqvh
欽	qqwy
釸	qqy
鍧	qqyg
鎦	qqyl
釣	qqyy
鈑	qrcy
鈲	qrcy
甮	qrej
鍎	qrfh
锧	qrfm
鉑	qrg
鍠	qrgg
锽	qrgg
銗	qrgk
鋲	qrgw
釿	qrh
鈝	qrhh
釽	qrhy
銖	qriy
曶	qrjf
錦	qrmh
匋	qrmk
遙	qrmp
鎎	qrno
鍁	qrqw
鑕	qrrm
錍	qrtf
鉄	qrwy
怱	qryn
鏢	qsfi
鉢	qsgg
釘	qsh
鐔	qsjh
鈳	qskg
鎶	qskk
殺	qsmc
錰	qsoy
鑻	qsqr
閷	qsuw
錸	qsww
鈢	qsy
弒	qsya
剎	qsyj
鉥	qsyy
獲	qtac
獏	qtad
獴	qtae
獦	qtan
玂	qtar
犽	qtat
狘	qtat
猉	qtaw
猻	qtbi
乮	qtbn
犼	qtbn
鉇	qtbn
獝	qtck
獁	qtcy
猅	qtdd
猰	qtdd
狵	qtde
狜	qtdg
銛	qtdg
铦	qtdg
鋒	qtdh
獂	qtdi
鑙	qtdj
鐈	qtdk
懖	qtdn
鏠	qtdp
獉	qtdt
獶	qtdt
獿	qtdt
狹	qtdw
犾	qtdy
鉃	qtdy
猨	qtec
猙	qteh
猺	qtem
銹	qten
銩	qtfc
鈓	qtfg
釺	qtfh
狋	qtfi
獳	qtfj
狤	qtfk
鋯	qtfk
獖	qtfm
鑽	qtfm
鋌	qtfp
獟	qtfq
銑	qtfq
犲	qtft
鍤	qtfv
狫	qtfx
猼	qtgf
錘	qtgf
鍾	qtgf
夝	qtgg
狉	qtgg
狟	qtgg
鉎	qtgg
犻	qtgh
鏼	qtgi
獺	qtgm
鑂	qtgo
鵟	qtgo
獮	qtgq
獓	qtgt
狓	qthc
玃	qthc
鈼	qthf
獹	qthl
猇	qthm
鎴	qthn
鋋	qthp
鎳	qths
獩	qtht
猟	qtih
狣	qtiq
獌	qtjc
猂	qtjf
狚	qtjg
鋓	qtjh
猲	qtjn
鏫	qtjs
鍑	qtjt
猑	qtjx
鉻	qtkg
狆	qtkh
玁	qtkt
獧	qtle
獨	qtlj
鏓	qtln
獑	qtlr
鎞	qtlx
玀	qtly
鐭	qtmd
鉓	qtmh
狦	qtmj
猦	qtmj
猯	qtmj
匔	qtmk
狪	qtmk
猧	qtmk
銄	qtmk
鋵	qtmn
銵	qtmt
鎫	qtmt
猠	qtmw
匑	qtmx
狽	qtmy
獕	qtmy
	qtn
猳	qtnc
峱	qtnm
釳	qtnn
狔	qtnx
獜	qtoh
鐇	qtol
悐	qton
鏭	qton
獛	qtoy
鍬	qtoy
猔	qtpi
獱	qtpm
獰	qtps
猽	qtpu
狖	qtpw
狶	qtqh
狝	qtqi
鑗	qtqi
狥	qtqj
猣	qtqt
犳	qtqy
猈	qtrf
獆	qtrf
獔	qtrf
狛	qtrg
猘	qtrj
狾	qtrr
獥	qtrt
鋨	qtrt
猍	qtsw
狇	qtsy
狏	qttb
狧	qttd
狅	qttf
獋	qttf
狌	qttg
狢	qttk
獢	qttk
犵	qttn
狿	qttp
獇	qtuc
獞	qtuf
猶	qtug
獈	qtul
猐	qtun
獙	qtut
鉖	qtuy
獀	qtvc
錗	qtvg
獵	qtvn
獡	qtvo
犱	qtvy
狑	qtwc
猤	qtwd
獅	qtwh
鏦	qtwh
獪	qtwj
獊	qtwk
獫	qtww
猚	qtwy
猭	qtxe
狕	qtxl
獼	qtxq
鋂	qtxu
乂	qty
鉌	qty
猵	qtya
獄	qtyd
猏	qtye
獽	qtye
釒	qtyg
犿	qtyh
猄	qtyi
犺	qtym
鸑	qtyo
獤	qtyt
獷	qtyw
釞	qtyy
鉼	quah
鎙	qube
鎈	quda
錈	qudb
鐥	qudk
	qudk
錓	qudn
鎹	qudp
鑨	qued
鐗	queg
鎆	quej
鐩	quep
斘	qufh
鈄	qufh
鉡	qufh
鉝	qug
鍆	qug
鐦	quga
鎂	qugd
鑭	qugi
鋅	quh
鐘	qujf
鐧	qujg
鏱	qujh
鐿	qujn
鏡	qujq
錇	qukg
鋭	qukq
鏳	qulj
鏑	qumd
鐠	quoj
鍗	quph
鎊	qupy
鉸	quqy
鐏	qusf
鏟	qutg
鎌	quvo
鎰	quwl
鉳	quxn
銻	quxt
鎡	quxx
镃	quxx
鐞	qvaf
匓	qvcc
銀	qvey
臽	qvf
銉	qvfh
鍵	qvfp
釹	qvg
鎪	qvhc
鏽	qvhh
録	qviy
鏁	qvjs
鉊	qvkg
銣	qvkg
錙	qvlg
鑞	qvln
镴	qvln
鎻	qvmy
釖	qvn
釚	qvn
燄	qvoo
鋟	qvpc
鹐	qvqg
欿	qvqw
勼	qvv
鵮	qvwo
釰	qvyy
釻	qvyy
釼	qvyy
鎓	qwcn
鈆	qwcy
鍛	qwdc
鉁	qwet
鉜	qwfy
錀	qwga
鑰	qwga
鍨	qwgd
銓	qwgg
鍮	qwgj
匌	qwgk
鉿	qwgk
鎿	qwgr
鐙	qwgu
鐱	qwgw
鎀	qwhe
鏅	qwhe
勽	qwi
鉩	qwiy
銳	qwkq
鍭	qwnd
鎢	qwno
鎚	qwnp
匃	qwnv
銝	qwsy
銋	qwtf
鈖	qwvn
鵭	qwvo
銼	qwwf
鑯	qwwg
鋊	qwwk
鏺	qwxc
鈋	qwxn
釟	qwy
鈴	qwyc
鎸	qwye
鎨	qwyf
錐	qwyg
鋡	qwyk
鎗	qwyk
鐫	qwym
鈐	qwyn
錜	qwyn
鐎	qwyo
鏶	qwys
鐑	qxfk
鏆	qxfm
錄	qxgi
鉧	qxgu
鈏	qxhh
鈟	qxhh
鎭	qxhw
銯	qxiy
鉘	qxjh
鐨	qxjm
鏹	qxkj
鑠	qxrs
匂	qxv
鈚	qxxn
鍇	qxxr
鐖	qxxt
鍍	qyac
鏣	qyao
鑛	qyaw
錞	qybg
鐓	qybt
錥	qyce
銃	qycq
鋶	qycq
鉱	qycy
銥	qyey
鎄	qyey
鉒	qygg
夊	qyi
鍄	qyiy
鑲	qyke
鈰	qymh
鎬	qymk
鈧	qymn
鈁	qyn
鍽	qyna
錑	qynd
釯	qynn
	qynn
	qynn
鑣	qyno
鈩	qynt
匄	qynv
鏕	qynx
麁	qynx
粂	qyou
鍦	qytb
毈	qytc
鏃	qytd
銂	qyth
鏇	qyth
贕	qytm
邎	qytp
鐮	qyuo
鄮	qyvb
鎯	qyvb
鋃	qyve
鑇	qyvf
鹠	qyvg
鏞	qyvh
鏮	qyvi
劉	qyvj
鎕	qyvk
貿	qyvm
鶹	qyvo
斵	qyvr
錊	qywf
鏲	qyxh
鉉	qyxy
鈫	qyy
錉	qqaj
獚	qtaw
猀	qtit
觰	qefj
觴	qetr
龬	qmun
龯	qdnt
龲	qylh
鿏	qgty
鿏	qgqt
鿐	qoig
鿔	qskk
鿕	qgmy
鿩	qojq
鿭	qqiy
鿳	qotx
鿴	qgtu
鿵	qgfn
鿶	qgye
鿷	qguj
鿸	qgtx
鿹	qgpm
兠	ruxq
劤	rlt
劧	rlt
劮	rwlt
劰	rlt
扐	rlt
挴	rtxy
捾	rphn
揻	rdgy
搣	rdgy
摵	rdhy
擑	rkby
擽	rrxs
攑	rvgh
攪	rvqq
樂	rxxs
甒	rlgy
皒	rtry
皪	rrxs
缻	rmgy
罀	rmqi
魆	rqcy
魕	rqcy
掗	rgfg
鼄	rixf
摟	rlvg
擻	rlvt
魕	rqcw
擠	ryjg
擛	raas
搑	rabg
掿	radk
揕	radn
掑	radw
拑	rafg
擆	rafj
撶	ragf
皣	ragf
捓	rahb
摼	rahf
挋	rahh
攬	rahq
擓	raiy
擖	rajn
掝	rakg
摳	rakk
擹	rakw
攤	raky
撗	ramw
摃	ramy
抴	rann
摕	raqh
撍	raqj
擏	raqt
擭	rawc
攃	rawi
攝	rbbb
掫	rbcy
撱	rbde
挕	rbg
邤	rbh
摂	rbiy
掹	rblg
扡	rbn
搎	rbti
摻	rcce
撡	rccn
	rccy
撪	rcdl
掻	rcjy
皅	rcn
抁	rcqn
捘	rcwt
払	rcy
瓥	rcyj
瓟	rcyn
扠	rcyy
瓝	rcyy
抜	rdcy
擾	rdet
掁	rdey
捹	rdfa
搙	rdff
拝	rdfh
撦	rdfj
鷎	rdfo
摦	rdfy
揻	rdgt
搣	rdgt
拵	rdhb
揳	rdhd
摵	rdht
揼	rdiy
擫	rdjd
抪	rdmh
頎	rdmy
拋	rdnl
拻	rdoy
摤	rdqq
挷	rdtb
攊	rdth
搸	rdwt
摏	rdwv
挾	rdww
扙	rdyy
捊	rebg
掤	reeg
揺	refb
抈	reg
抯	regg
覛	rehq
皭	relf
皧	rept
挅	resy
採	resy
撝	reto
挼	revg
搯	revg
掙	revh
扱	reyy
擮	rfay
搕	rfcl
抎	rfcy
抾	rfcy
擩	rfdj
掛	rffh
摴	rffn
撓	rffq
皢	rffq
扗	rfg
扞	rfh
瞂	rfhc
攧	rfhm
鶞	rfho
搷	rfhw
抺	rfiy
捄	rfiy
皁	rfj
撠	rfja
搆	rfjf
擡	rfkf
擷	rfkm
擜	rfmd
揇	rfmf
乕	rfmh
貭	rfmi
逓	rfmp
擣	rfnf
扝	rfnn
捇	rfoy
挬	rfpb
撎	rfpu
抏	rfqn
搘	rftj
撻	rfup
攆	rfwl
攅	rfwm
摫	rfwq
掕	rfwt
皬	rfwy
挵	rgah
扽	rgbn
挃	rgcf
捯	rgcj
巵	rgcv
掅	rgeg
皘	rgeg
扜	rgfh
抂	rgg
掗	rghg
抷	rgig
皝	rgiq
抔	rgiy
摶	rgjf
挭	rgjq
皩	rgjq
郈	rgkb
垕	rgkf
搹	rgkh
捒	rgki
揦	rgkj
劶	rgkl
揊	rgkl
攋	rgkm
摗	rgkw
揀	rgli
拺	rgmi
攦	rgmx
掚	rgmy
皟	rgmy
屔	rgnx
挜	rgog
搢	rgoj
挒	rgqj
扤	rgqn
皌	rgsy
挳	rgva
捿	rgvv
擟	rgwq
挗	rgxw
據	rhae
摣	rhag
	rhag
摢	rhah
擄	rhal
攎	rhal
虒	rham
攄	rhan
鷉	rhao
遞	rhap
歋	rhaw
掯	rheg
鵇	rhfo
挊	rhgh
拤	rhhy
掓	rhic
捗	rhit
吿	rhkf
揁	rhmy
挸	rhqn
欫	rhqw
犇	rhth
皉	rhxn
坕	rhyf
爮	rhyn
	rian
皐	rifj
翶	rifn
挱	riit
鼄	rimv
摚	ripf
擋	ripl
攩	ripo
撹	ripq
撐	ript
挄	riqn
灥	riri
楽	risu
挘	ritl
毮	ritn
鴸	riwo
擝	rjel
捚	rjfg
皔	rjfh
抇	rjg
揚	rjgr
捑	rjgy
捜	rjhc
摱	rjlc
搨	rjng
掦	rjqr
掲	rjqx
捰	rjsy
掍	rjxx
撔	rjyi
擑	rkbt
挰	rkgg
擻	rkgt
摟	rkgv
撌	rkhm
撣	rkkf
捛	rkkg
損	rkmy
拀	rkqn
抧	rkwy
摑	rlag
擺	rlcx
畠	rlf
擇	rlff
搟	rlfh
鄦	rlgb
揋	rlge
甒	rlgn
無	rlgo
鷡	rlgo
橆	rlgs
捙	rlh
拁	rlkg
搚	rlle
攌	rlle
拹	rlll
攂	rlll
劤	rln
劧	rln
劰	rln
扐	rln
揌	rlny
摙	rlpy
擉	rlqj
斶	rlqj
摲	rlrh
搵	rlwl
擃	rmae
捵	rmaw
缷	rmbh
抰	rmdy
搰	rmeg
抩	rmfg
皗	rmfk
挏	rmgk
缻	rmgn
皚	rmgu
製	rmhe
緜	rmhi
罏	rmhl
罀	rmiq
罉	rmir
罎	rmjc
罁	rmmm
攖	rmmv
撾	rmnp
缹	rmou
缼	rmqw
	rmqy
缿	rmrk
缽	rmsg
罈	rmsj
挆	rmsy
缾	rmua
罇	rmuf
掆	rmum
攜	rmwk
抐	rmwy
皠	rmwy
罆	rmxm
戶	rnd
扟	rnfh
挧	rng
氫	rnga
揯	rngg
搄	rngg
氬	rngg
氭	rngi
氞	rngw
揟	rnhe
摪	rnhf
摨	rnih
氜	rnjf
刏	rnjh
氠	rnjh
氱	rnjr
氳	rnll
氝	rnmw
癿	rnn
挶	rnnk
忥	rnnu
氣	rnou
気	rnqu
乺	rnrn
氥	rnsf
捤	rntn
搱	rnuh
摎	rnwe
紥	rnxi
抳	rnxn
抋	rny
択	rnyy
擈	rogw
撲	rogy
攚	rook
撈	rool
掞	rooy
撛	roqh
廹	rpd
搳	rpdk
攇	rpdn
攐	rpfe
攓	rpfh
捖	rpfq
擯	rpgm
揮	rplh
抭	rpmn
捾	rpnn
擰	rpns
捥	rpqb
抌	rpqn
挓	rpta
揢	rptk
揬	rpwd
搾	rpwf
摍	rpwj
搈	rpwk
攛	rpwn
摉	rpwq
搉	rpwy
搲	rpwy
攨	rpwy
拕	rpxn
扺	rqan
搩	rqas
皃	rqb
搊	rqbt
鬾	rqcc
鬽	rqce
魓	rqcf
魊	rqcg
魖	rqcg
魒	rqci
魀	rqcj
魐	rqco
鬿	rqcr
魆	rqct
魕	rqct
魌	rqcw
抅	rqcy
魋	rqcy
魎	rqcy
撚	rqdo
擔	rqdy
捔	rqeh
捦	rqg
攙	rqky
換	rqmd
擼	rqoj
撳	rqqw
拸	rqqy
搖	rqrm
揔	rqrn
摋	rqsc
抣	rqug
扻	rqwy
揈	rqyg
扚	rqyy
鋬	rrcq
皞	rrdf
硩	rrdf
埑	rrff
揗	rrfh
拞	rrgg
揘	rrgg
捳	rrgm
捠	rrgw
抙	rrh
斦	rrh
擨	rrhw
皡	rrif
晢	rrjf
啠	rrkf
撫	rrlo
劕	rrmj
質	rrmu
乴	rrnb
悊	rrnu
烲	rrou
焎	rrou
銴	rrqf
皛	rrrf
皨	rrrf
掱	rrrj
梊	rrsu
娎	rrvf
抶	rrwy
裚	rrye
撽	rryt
皦	rryt
摽	rsfi
拪	rsg
撢	rsjh
抲	rskg
搮	rssy
抍	rtah
扥	rtan
逰	rtbp
捀	rtdh
撟	rtdk
摓	rtdp
擌	rtdw
扷	rtdy
捁	rtfk
攢	rtfm
鵯	rtfo
揷	rtfv
揰	rtgf
挿	rtgh
	rtgt
搝	rthd
拃	rthf
皥	rthf
揝	rthj
扸	rthn
挻	rthp
摥	rtjr
挌	rtkg
摠	rtln
擙	rtmd
拠	rtmn
抸	rtpy
皒	rtrt
	rtt
擶	rtuj
擳	rtvb
捼	rtvg
摐	rtwh
撘	rtwk
挴	rtxu
敀	rty
扖	rtyy
皏	ruah
捲	rudb
攁	rude
撯	rudh
搼	rudr
攏	rued
撊	rueg
揃	ruej
捫	rug
撋	rugg
攔	rugi
摬	rujq
搃	rukn
捝	rukq
擿	rump
掽	ruog
揥	ruph
搒	rupy
挍	ruqy
擲	rusb
揂	rusg
摌	rutg
擱	rutk
搤	ruwl
揹	ruxe
挮	ruxt
撏	rvaf
揑	rvag
揤	rvcb
摡	rvcq
拫	rvey
揵	rvfp
挦	rvfy
捸	rviy
摷	rvjs
擸	rvln
扏	rvn
慇	rvnn
掃	rvph
掜	rvqn
扨	rvyy
捴	rwcn
抮	rwet
攑	rwfh
摖	rwfi
捨	rwfk
攪	rwfq
掄	rwga
揜	rwga
掵	rwgb
撜	rwgu
撿	rwgw
扴	rwjh
挩	rwkq
劮	rwln
摀	rwno
搥	rwnp
怣	rwnu
拰	rwtf
捈	rwty
摿	rwuj
扵	rwuy
搗	rwvm
攕	rwwg
鴩	rwwo
撥	rwxc
皊	rwyc
	rwyc
搇	rwye
搶	rwyk
勧	rwyl
扲	rwyn
撨	rwyo
観	rwyq
歓	rwyw
墍	rxaf
曁	rxag
旣	rxaq
槩	rxas
皀	rxb
卽	rxbh
皍	rxbj
攭	rxej
摜	rxfm
摾	rxkj
抝	rxnn
撧	rxqc
擽	rxrs
皪	rxrs
擬	rxth
擴	ryaw
摛	rybc
撴	rybt
攡	ryby
拡	rycy
挔	ryey
抃	ryhy
皜	rymk
揙	ryna
搧	rynn
攗	ryno
皫	ryno
攈	rynt
攟	rynt
摝	rynx
攍	ryny
揨	ryps
掋	ryqy
攠	rysd
擵	rysr
揓	rytb
鸄	ryto
譥	ryty
擠	ryvf
掶	ryvw
捬	rywf
捽	rywf
撁	ryxh
擁	ryxy
抆	ryy
挀	rrey
扢	rtnn
擕	rwym
捪	rqaj
掼	rxfm
掼	rxf
揷	rtgh
龵	rtgt
鿜	rugq
鿫	rntd
鿯	rhqo
朷	svt
朸	slt
杻	snhf
枌	swvt
枴	skvt
柪	sxlt
柺	sklt
栂	sxyy
栧	sjnt
栰	sway
桟	sdny
桺	sgjn
棑	shdd
棧	saay
椷	sdgy
楲	sdgy
橊	sgjl
機	sxxy
橷	sruq
橻	snhf
檅	shdy
檌	slhd
檝	skby
檥	sugy
櫗	saly
櫟	srxs
櫸	svgh
欅	svgr
欌	sady
醎	sgdy
麥	swwq
櫹	savj
椏	sgfg
樮	sgjo
棩	sjgg
樓	slvg
櫢	slvt
櫷	stxg
橚	svfj
麴	swwo
檇	swym
櫅	syjg
栻	saag
櫙	saak
棧	saat
榵	sabg
桏	sabh
樭	sadf
楛	sadg
櫀	sadi
楉	sadk
欌	sadt
橵	saet
杢	saf
覊	safc
覇	safe
覉	safk
樲	safm
楳	safs
樺	sagf
橫	sagw
樫	sahf
栕	sahh
檻	sahl
欖	sahq
枒	saht
欂	saif
橗	saje
棤	sajg
椻	sajv
棫	sakg
樞	sakk
櫃	sakm
欟	sakq
權	saky
櫣	salp
櫗	salt
楧	samd
槓	samy
樠	samy
枻	sann
楪	sans
槆	saqj
橬	saqj
檧	saqn
樥	sath
欗	saui
櫹	savh
檴	sawc
﨓	sawf
櫒	sawi
榙	sawk
檋	sawl
櫵	sawo
欍	sawv
椛	sawx
栱	sawy
杙	say
欇	sbbb
棷	sbcy
橢	sbde
杍	sbg
栮	sbg
樄	sbgi
邒	sbh
極	sbkg
檉	sbkg
柮	sbmh
杝	sbn
槂	sbti
櫲	scbe
壄	scbf
楙	scbs
楺	scbs
柕	scbt
棳	sccc
槮	scce
槡	sccs
椮	scde
桳	scdf
樋	scep
枱	sckg
桙	scrh
榪	scy
楕	sdae
檶	sdak
櫔	sday
枙	sdbn
柭	sdcy
栯	sdeg
楜	sdeg
櫌	sdet
棖	sdey
桭	sdfe
楏	sdff
槈	sdff
櫉	sdff
桍	sdfn
槬	sdfy
椷	sdgt
楲	sdgt
栫	sdhb
櫘	sdhn
榎	sdht
槥	sdhv
棑	sdjd
栢	sdjg
槗	sdkk
柨	sdmh
栭	sdmj
頂	sdmy
杤	sdnn
遷	sdnp
樉	sdqq
榞	sdri
梼	sdtf
櫪	sdth
橭	sduh
橑	sdui
樁	sdwv
梜	sdww
桟	sdxy
杕	sdy
枤	sdy
檼	sean
棴	sebc
楥	sefc
枂	seg
査	segf
柤	segg
橓	seph
櫾	seri
榣	serm
桗	sesy
棌	sesy
橳	seul
桵	sevg
槄	sevg
榽	sexd
椓	seyy
欛	sfae
枿	sfah
橨	sfam
榼	sfcl
枟	sfcy
檽	sfdj
垔	sff
橒	sffc
橈	sffq
槙	sfhw
彯	sfie
隸	sfii
飄	sfij
勡	sfil
顠	sfim
翲	sfin
歀	sfiw
柡	sfiy
梂	sfiy
橶	sfja
榸	sfjf
構	sfjf
檊	sfjf
枾	sfjg
榬	sfke
樹	sfkf
檯	sfkf
橲	sfkk
櫺	sfkk
欞	sfkw
櫝	sflm
檮	sfnf
杇	sfnn
梽	sfny
桲	sfpb
杬	sfqn
歅	sfqw
榰	sftj
橽	sfup
樰	sfvg
檣	sfwk
櫕	sfwm
槻	sfwq
枎	sfwy
槸	sfwy
醆	sgaa
枅	sgah
梇	sgah
醧	sgak
橊	sgal
桺	sgan
醼	sgao
杶	sgbn
醊	sgcc
醦	sgce
椡	sgcj
酭	sgde
醃	sgdn
醎	sgdt
酻	sgeb
榑	sgef
釂	sgef
棈	sgeg
醻	sgff
杅	sgfh
醏	sgfj
醹	sgfj
醽	sgfk
醘	sgfl
酛	sgfq
酜	sgfw
酑	sggf
醩	sggj
釃	sggx
酺	sggy
柾	sghg
椏	sghg
覀	sghg
酟	sghk
朩	sghy
柸	sgig
桮	sgik
槫	sgjf
棟	sgji
醖	sgjl
橞	sgjn
欜	sgke
槅	sgkh
梀	sgki
楋	sgkj
櫮	sgkk
楅	sgkl
櫴	sgkm
釅	sgkt
梪	sgku
樕	sgkw
醳	sglf
橿	sglg
醞	sgll
酘	sgmc
醲	sgme
杮	sgmh
栜	sgmi
醠	sgml
欐	sgmx
樍	sgmy
翉	sgng
酦	sgny
榗	sgoj
醈	sgoo
梾	sgoy
逎	sgpd
酧	sgpf
醡	sgpf
醓	sgpl
酖	sgpq
栵	sgqj
醄	sgqm
醜	sgrc
醥	sgsi
醰	sgsj
酠	sgsk
醂	sgss
枺	sgsy
酕	sgtn
醝	sgua
醸	sgue
酙	sguf
醷	sgun
桱	sgva
醙	sgvc
酔	sgvf
醁	sgvi
棲	sgvv
醱	sgwc
酫	sgwg
檷	sgwq
醗	sgwq
醶	sgww
醀	sgwy
酳	sgxe
枑	sgxg
榡	sgxi
桋	sgxw
醨	sgyc
釄	sgyd
釀	sgye
醿	sgyi
醕	sgyj
醾	sgyo
酼	sgyq
樝	shag
櫨	shal
椃	sham
櫖	shan
榩	shay
櫇	shcm
柀	shcy
檅	shdt
杫	shg
桛	shgh
欔	shhc
欋	shhy
槕	shjs
枮	shkg
樐	shlo
楨	shmy
檙	shnn
梘	shqn
椇	shwy
橴	shxi
檔	sipl
欓	sipo
橖	sips
橕	sipt
桜	sivg
樑	sivs
﨔	siwr
樶	sjbc
榯	sjff
梩	sjfg
桿	sjfh
皶	sjgc
棏	sjgf
柦	sjgg
鸉	sjgo
楊	sjgr
柛	sjhh
榥	sjiq
椙	sjjg
橸	sjjj
螙	sjju
槾	sjlc
榅	sjlg
楬	sjqn
鷣	sjwo
栧	sjxt
檝	skbt
梋	skeg
桯	skgg
櫢	skgt
樓	skgv
杊	skh
樻	skhm
樿	skkf
梠	skkg
梙	skkh
楍	skkk
槵	skkn
橾	skks
欕	skkt
柺	skln
柷	skqn
戨	sksa
枴	skvn
槶	slag
檌	sldd
棝	sldg
栶	sldy
檡	slff
柶	slg
椳	slge
檈	slge
檲	slgf
椢	slgy
欙	slli
栛	slll
櫑	slll
朸	sln
楒	slny
梿	slpy
槤	slpy
梱	slsy
棞	slty
楐	slwj
榲	slwl
樏	slxi
欏	slxy
檂	smae
柵	smah
欁	smas
椣	smaw
杸	smcy
椯	smdj
柍	smdy
榾	smeg
枏	smfg
柟	smfg
椆	smfk
梬	smgn
榿	smgu
杣	smh
櫻	smmv
楇	smnk
檛	smnp
	smqy
楓	smtj
賈	smu
棡	smum
棢	smun
欈	smwk
梣	smwn
梤	smwv
槯	smwy
梖	smy
枬	smyg
杋	smyy
榐	snae
朰	snb
樼	snbb
橻	snff
杻	snfg
楃	sngf
柌	sngk
椵	snhc
楈	snhe
梉	snhf
朻	snhh
椲	snhh
欘	snij
蚻	snju
檘	snku
梮	snnk
梞	snny
槢	snrg
榓	sntl
梶	sntn
柲	sntt
榌	snuh
樛	snwe
櫂	snwy
紮	snxi
柅	snxn
杺	sny
欉	sogc
檏	sogw
樸	sogy
橩	soof
檆	sook
櫿	sook
橯	sool
棪	sooy
橉	soqh
廼	spd
迺	spd
槣	spdk
櫶	spdn
椬	speg
榢	spey
梡	spfq
榁	spgf
椗	spgh
檳	spgm
榠	spju
楎	splh
橣	spne
櫁	spnj
樒	spnm
檸	spns
椀	spqb
楁	sptk
榟	spuh
椌	spwa
樎	spwj
棎	spws
柼	spwy
榊	spyh
桝	sqah
棔	sqaj
桰	sqak
榤	sqas
枊	sqbh
栁	sqbh
桞	sqbh
椶	sqbt
栬	sqcn
桸	sqdh
橪	sqdo
檞	sqeh
栒	sqjg
梚	sqkq
欃	sqky
枹	sqnn
櫓	sqoj
櫯	sqot
椈	sqoy
礬	sqqd
鬰	sqqe
欎	sqqf
欝	sqqf
蠜	sqqj
燓	sqqo
鐢	sqqq
棥	sqqs
栘	sqqy
楤	sqrn
榝	sqsc
樧	sqsc
梑	sqto
枃	squg
檭	sqve
棦	sqvh
杴	sqwy
橮	sqym
杦	sqyy
梍	sran
柧	srcy
栃	srdn
楯	srfh
梔	srgc
楻	srgg
梹	srgw
杽	srh
榹	srhm
枛	srhy
槹	srif
檪	sris
楾	sriy
晳	srjf
蜤	srju
橅	srlo
鬱	srme
惁	srnu
櫆	srqf
櫍	srrm
椞	srsu
椑	srtf
柣	srwy
権	srwy
梎	srxn
槪	srxq
覈	sryt
樷	ssbc
櫏	ssdp
埜	ssff
標	ssfi
檦	ssfj
梄	ssgg
梺	ssgh
槱	ssgo
朾	ssh
橝	ssjh
榃	sslf
檒	ssmj
槚	ssmy
檟	ssmy
樮	ssoy
棾	sspm
椘	sspu
檚	sssh
楆	ssvg
棽	sswn
鷅	sswo
棶	ssww
枡	stah
栙	stah
杔	stan
檱	staw
柂	stbn
桻	stdh
椥	stdk
橋	stdk
槰	stdp
枖	stdy
杄	stfh
櫡	stfj
欑	stfm
枆	stfn
栍	stgg
棅	stgi
櫄	stgo
橰	sthf
棩	sthh
梴	sthp
櫋	sthy
椼	stih
楿	stjg
梸	stjh
椱	stjt
楀	stky
桖	stlg
樬	stln
櫷	stmg
栴	stmy
杚	stnn
柹	stnt
橎	stol
覂	stpu
柉	stpy
橁	stqj
櫤	stuj
柊	stuy
櫛	stvb
樅	stwh
柇	sty
樦	styg
杁	styy
栟	suah
樴	suaj
棬	sudb
橏	sudk
椦	sudl
栚	sudy
櫳	sued
橌	sueg
椾	suej
檖	suep
枓	sufh
柈	sufh
柆	sug
椚	sug
橍	sugg
様	sugi
樣	sugi
欄	sugi
榚	sugo
檥	sugt
檨	sugw
栤	suiy
椫	sujf
橦	sujf
橺	sujg
槞	sujn
檍	sujn
樈	sujq
棓	sukg
櫚	sukk
棁	sukq
橧	sulj
樀	sumd
椪	suog
楴	suph
櫩	suqv
栨	suqw
橷	surq
橂	susd
楢	susg
櫬	susq
槉	sutd
楌	sute
櫊	sutk
檤	sutp
椄	suvg
槏	suvo
榏	suwl
檓	svac
樳	svaf
楖	svcb
櫭	svcg
梛	svfb
枠	svfh
桪	svfy
橚	svhh
椂	sviy
樔	svjs
柖	svkg
椔	svlg
朷	svn
朹	svn
梫	svpc
棿	svqn
覅	svqr
桚	svqy
桾	svtk
榋	svvv
楰	svwy
梕	svyn
杒	svyy
栰	swat
棇	swcn
枩	swcu
覄	swdu
栿	swdy
櫸	swfh
欅	swfr
柎	swfy
棆	swga
椧	swgb
楡	swgb
楑	swgd
檜	swgj
櫈	swgm
枍	swgn
楩	swgq
検	swgw
檢	swgw
樇	swhe
樤	swhs
厀	swib
桼	swiu
柗	swkg
梲	swkq
椺	swks
桘	swnn
栣	swtf
梌	swty
槝	swvm
枌	swvn
樢	swvo
椕	swvs
麯	swwa
郲	swwb
麬	swwc
麮	swwc
麶	swwc
猌	swwd
麵	swwd
桽	swwf
櫼	swwg
麰	swwh
來	swwi
勑	swwl
賚	swwm
顂	swwm
愸	swwn
憖	swwn
憗	swwn
麧	swwn
麪	swwn
麫	swwn
麭	swwn
鶆	swwo
逨	swwp
麲	swwq
麥	swwt
麨	swwt
麷	swwu
麩	swww
麳	swww
麱	swwy
橃	swxc
梻	swxj
杹	swxn
朲	swy
朳	swy
欆	swyc
槜	swye
梒	swyk
槍	swyk
枔	swyn
棯	swyn
檇	swyn
欚	sxej
樌	sxfm
栂	sxgu
槇	sxhw
栺	sxjg
柫	sxjh
柪	sxln
朼	sxn
杛	sxn
檰	sxrh
櫟	sxrs
榒	sxuu
櫞	sxxe
梐	sxxf
檵	sxxn
機	sxxt
樜	syao
櫎	syaw
槨	sybb
樆	sybc
梈	sybh
橔	sybt
棛	syce
橀	sycl
堏	syff
櫥	syff
櫧	syfj
欀	syke
櫰	syle
檁	sylt
楄	syna
槴	sync
棙	synd
栐	syni
杧	synn
枦	synt
櫦	synt
怸	synu
樚	synx
椖	syny
檺	sype
鶐	sypo
楟	syps
橠	syqe
椸	sytb
栦	syth
檹	sytk
榳	sytp
桹	syve
樃	syve
櫅	syvf
槦	syvh
槺	syvi
榶	syvk
椩	syvw
櫠	sywc
椊	sywf
椨	sywf
棜	sywu
棭	sywy
槒	syxl
辳	ssde
権	stdy
缌	sawp
鿝	slyq
乗	tgai
勄	txyl
埀	tfuf
慜	txyn
瀪	txyi
牞	trlt
牥	tryt
牫	tray
牳	trxy
犠	truy
犧	truy
瓾	tvgy
甀	tfay
甁	tfty
甃	togy
甈	thsy
秎	twvt
稶	tgky
穖	txxy
穢	thdy
穥	tvgw
竻	tlr
筄	tqiu
筬	tdny
箋	taau
箠	ttfg
篯	tqgu
籂	twph
籅	tvgw
籈	tsfy
緐	txyi
舠	tevt
艞	teti
艤	teuy
艥	teky
衊	tlay
郵	tfab
馡	tjhd
鰵	txyo
齀	thly
鼅	tdkx
艛	telv
艩	teyj
稏	tgfg
囱	tlti
悤	tltn
簍	tlvf
籔	tlvt
龝	ttxg
簫	tvfj
龜	txd
穧	tyjg
箋	taar
穁	tabg
笻	tabj
簊	tadf
簛	tadr
稘	tadw
篋	tadw
笁	taf
簕	tafl
篏	tafw
筺	tagy
夅	tahj
籃	tahl
熈	taho
笌	taht
徣	tajg
稓	tajg
稶	take
稢	takg
籄	takm
筪	talj
篫	tamr
築	tams
篢	tamu
穔	tamw
笹	tanb
秬	tang
衐	tanh
徔	tapy
穫	tawc
籆	tawc
衖	tawh
簭	tawk
遾	tawp
竾	tbb
箃	tbcu
秄	tbg
篜	tbio
笜	tbmj
彵	tbn
箛	tbry
篨	tbwt
笲	tcaj
穇	tcce
篸	tcce
	tcde
筩	tcej
秮	tckg
篤	tcu
稄	tcwt
矱	tdac
叐	tdcu
秡	tdcy
頢	tddm
箶	tdef
衚	tdeh
圱	tdfg
秙	tdg
稧	tdhd
夆	tdhj
蠭	tdhj
篲	tdhv
筙	tdiu
昋	tdjf
刋	tdjh
舓	tdjr
聟	tdkb
敽	tdkc
呑	tdkf
喬	tdkk
勪	tdkl
鷮	tdko
敿	tdkt
鼅	tdkv
矲	tdlx
稬	tdmd
舑	tdmf
舏	tdnh
嵆	tdnm
筬	tdnt
諬	tdny
舕	tdoo
舚	tdqy
徛	tdsk
矨	tdtd
舙	tdtd
矪	tdte
矯	tdtk
簝	tdui
矰	tduj
箺	tdwj
谸	tdwk
鴁	tdwo
鴙	tdwo
鴰	tdwo
筴	tdww
艧	teac
艜	teah
艦	teal
穩	tean
艓	teas
舼	teaw
箙	tebc
筟	tebf
郍	tebh
舥	tecn
頺	tedm
舿	tedn
舦	tedy
艀	teeb
稝	teeg
艢	tefk
艝	tefv
笡	tegf
筯	tegl
稲	tehj
艣	tehl
艫	tehl
艡	teil
艃	tejf
艒	tejh
甪	tek
艥	tekt
艛	tekv
穱	telf
舺	telh
褩	teme
稱	temf
鞶	temf
幋	temh
縏	temi
螌	temj
盤	teml
鎜	temq
搫	temr
槃	tems
媻	temv
舤	temy
艍	tend
篴	tepu
鸼	teqg
艪	teqj
艐	teqt
艬	teqy
簲	terf
艎	terg
艊	terh
舽	teth
艂	teth
艁	tetk
艞	tetq
舧	tety
艖	teua
籐	teui
籘	teui
艗	teul
艤	teut
艕	teuy
箏	tevh
穏	tevn
舠	tevn
舩	tewc
舲	tewc
艭	tewc
艙	tewk
艌	tewn
鵃	tewo
艅	tewt
艠	tewu
徯	texd
艑	teya
艔	teyc
艆	teye
艩	teyf
舮	teyn
艈	teyq
彶	teyy
籖	tfag
篕	tfcl
秐	tfcy
秓	tfcy
	tfd
穤	tfdj
玍	tff
筀	tfff
篈	tfff
徍	tffg
衎	tffh
徺	tffq
穘	tffq
秲	tffy
簙	tfgf
啎	tfgk
徝	tfhg
稙	tfhg
鸻	tfhg
衠	tfhh
憄	tfhn
鴴	tfho
簳	tfjf
籉	tfkf
穯	tfkk
勂	tfkl
頶	tfkm
鵠	tfko
徳	tfln
毧	tfnd
毴	tfnd
氁	tfnd
毝	tfne
毶	tfne
籌	tfnf
氊	tfng
毜	tfni
毥	tfnj
毺	tfnj
氌	tfnj
毰	tfnk
毸	tfnn
毩	tfno
毱	tfno
毨	tfnq
覒	tfnq
毢	tfns
忎	tfnu
毬	tfny
頲	tfpm
颋	tfpm
笎	tfqb
酂	tfqb
酇	tfqb
衏	tfqh
劗	tfqj
贊	tfqm
兟	tfqq
幷	tftf
筓	tftf
甁	tftn
逬	tftp
敮	tfvc
臿	tfvd
稑	tfwf
簮	tfwj
穡	tfwk
稜	tfwt
籗	tfwy
籱	tfwy
郵	tgab
剰	tgaj
筭	tgaj
甀	tgan
乗	tgas
秷	tgcf
箌	tgcj
簠	tgel
秿	tgey
彺	tgg
稏	tghg
徰	tghh
篶	tgho
秠	tgig
篿	tgjf
濌	tgjj
動	tgjl
憅	tgjn
勲	tgjo
稉	tgjq
稫	tgkl
籟	tgkm
徚	tgli
勳	tgll
箣	tgmj
穂	tgmn
簀	tgmu
穲	tgmx
籭	tgmx
積	tgmy
甧	tgte
甡	tgtg
埀	tguf
徑	tgva
徢	tgvh
箑	tgvh
穪	tgwq
籋	tgwq
籚	thal
箎	tham
籧	thap
簴	thaw
郋	thbh
秛	thcy
篹	thdb
鄓	thdb
簒	thdc
籑	thde
穢	thdt
牋	thga
牑	thga
牉	thgf
牔	thgf
牗	thgh
牏	thgj
牊	thgk
牘	thgm
牎	thgn
牕	thgn
覑	thgq
牐	thgv
臰	thgx
牓	thgy
籰	thhc
忂	thhy
臯	thif
翺	thin
鷱	thio
徏	thit
篎	thit
笘	thkf
秥	thkg
齆	thlc
齅	thld
齈	thle
齉	thle
齇	thlg
鼼	thlh
齂	thli
齁	thlk
齀	thln
齃	thln
鼿	thlq
鄎	thnb
臫	thnn
郔	thpb
蜑	thpj
邉	thpp
邊	thpp
臱	thpy
筧	thqb
臲	thsb
甈	thsn
鷍	thso
辠	thuj
臮	thwy
篊	tiaw
笵	tibb
筂	tibb
箈	tick
箾	tiej
箥	tihc
乑	tii
篞	tijf
簜	tijr
簹	tipl
筄	tiqb
箵	tith
籓	titl
箲	titq
尓	tiu
筜	tivf
簗	tivs
馢	tjaa
篳	tjaf
穝	tjbc
忁	tjbi
馛	tjdc
馡	tjdd
馣	tjdn
馟	tjeb
馞	tjfb
稈	tjfh
筸	tjfj
馩	tjfm
徥	tjgh
馧	tjjl
馤	tjjn
馝	tjnt
悡	tjnu
馜	tjnx
馪	tjpm
鋫	tjqf
篂	tjtg
馫	tjtj
馦	tjuo
馠	tjwk
馚	tjwv
箟	tjxx
箿	tkbf
頟	tkdm
筽	tkgd
徎	tkgg
籔	tkgt
簍	tkgv
簬	tkhk
簣	tkhm
洜	tkiu
筥	tkkf
簞	tkkf
鄅	tkmb
筼	tkmu
篔	tkmu
惒	tknu
兎	tkqy
敋	tkty
鵅	tkwo
簂	tlag
簚	tlah
衊	tlat
穓	tlaw
竻	tlb
範	tlbb
衈	tlbg
卹	tlbh
笝	tlcu
甶	tld
箇	tldf
稒	tldg
筃	tldu
稩	tleg
盉	tlf
笽	tlf
衃	tlgi
笚	tlj
簤	tlmu
顖	tlqm
恖	tlqn
悤	tlqn
欰	tlqw
簐	tlqw
衇	tlre
囪	tlry
稇	tlsy
衆	tlti
簵	tltk
衉	tltk
箘	tltu
稛	tlty
邍	tlvp
衂	tlvy
籮	tlxy
穠	tmae
筁	tmaf
垼	tmcf
躻	tmda
躾	tmdd
躴	tmde
躼	tmde
軃	tmdf
軇	tmdf
躰	tmdg
躿	tmdi
篅	tmdj
軄	tmdj
躳	tmdk
躸	tmdk
軀	tmdk
軂	tmdl
軉	tmdm
頽	tmdm
躵	tmdn
軈	tmdn
躹	tmdo
鵢	tmdo
躭	tmdq
躱	tmds
躶	tmds
軆	tmdu
躮	tmdv
躷	tmdv
躽	tmdv
軁	tmdv
軅	tmdy
簓	tmfe
徟	tmfk
秞	tmg
龜	tmgg
衕	tmgh
秱	tmgk
懲	tmgn
徴	tmgt
黴	tmgt
秈	tmh
屲	tmj
穨	tmkm
逈	tmkp
笧	tmmg
簻	tmnp
嶴	tmom
奧	tmtd
粵	tmtn
幑	tmtt
筫	tmu
凢	tmv
処	tmv
鵚	tmwo
笍	tmwu
箆	tmwx
徾	tmyt
竼	tmyu
笢	tnab
箼	tngf
徦	tnhc
稰	tnhe
篃	tnhf
徫	tnhh
稦	tnhh
衛	tnhh
衞	tnhh
躗	tnhh
躛	tnhh
讆	tnhy
讏	tnhy
徲	tnih
穉	tnih
刉	tnjh
簨	tnnw
簈	tntf
箳	tnua
稺	tnuh
穋	tnwe
籊	tnwy
秜	tnxn
笖	tnyw
甃	togn
穙	togy
釆	toi
湬	toiu
稥	tojf
蝵	toju
釋	tolf
飜	tolh
勫	toll
鷭	tolo
釈	tony
簩	tool
鍫	toqf
鹙	toqg
揫	torj
醔	tosg
夈	tou
媝	tovf
鶖	towo
秾	tpey
簆	tpfc
簺	tpff
徖	tpfi
筦	tpfq
箮	tpgg
穦	tpgm
筞	tpsu
秺	tpta
穃	tpwk
鴔	tpwo
篧	tpwy
簶	tpyi
籛	tqaa
秖	tqan
彽	tqay
秪	tqay
禿	tqb
稯	tqbt
篘	tqbt
頹	tqdm
簷	tqdy
銜	tqfh
穞	tqgj
篯	tqgr
箰	tqjb
筍	tqjf
穐	tqjn
笣	tqnb
穭	tqoj
笅	tqqu
笷	tqtb
籦	tqtf
犂	tqth
睝	tqth
鯬	tqto
鵹	tqto
邌	tqtp
錅	tqtq
棃	tqts
剓	tqtv
笉	tquf
籙	tqvi
彴	tqyy
犕	trae
簎	traj
牫	trat
牠	trbn
犙	trce
笟	trcy
牜	trd
牻	trde
犡	trdy
簼	trff
犆	trfh
犢	trfm
牼	trga
籒	trgl
犑	trhd
衘	trhh
禦	trhi
秼	triy
犦	trji
箉	trkl
籜	trlf
牭	trlg
牞	trln
犤	trlx
牰	trmg
犅	trmm
犌	trnc
鵝	trno
鵞	trno
牸	trpb
犗	trpk
觕	trqe
惣	trqn
犓	trqt
牴	trqy
篺	trrf
牪	trrh
犔	trro
牱	trsk
犐	trtf
箄	trtf
犞	trtk
牬	trtt
犈	trub
犝	truf
犃	truk
犠	trut
犧	trut
犪	trut
犣	trvn
牣	trvy
牷	trwg
籡	trww
牳	trxu
犉	tryb
牨	trym
牤	tryn
牥	tryn
犥	tryo
犜	tryt
篐	tsah
簯	tsaw
徱	tsfi
篻	tsfi
籈	tsfn
徆	tsg
笴	tskf
籕	tsql
箖	tssu
徠	tsww
箂	tsww
術	tsyh
秅	ttan
筈	ttdf
秳	ttdg
穚	ttdk
簥	ttdk
笶	ttdu
秗	ttdy
筕	ttfh
秊	ttfj
秊	ttfj
筶	ttfk
穳	ttfm
籫	ttfm
秏	ttfn
筳	ttfp
簉	ttfp
	ttg
種	ttgf
箠	ttgf
箽	ttgf
徃	ttgg
衝	ttgh
	ttgy
秨	tthf
簰	tthf
簁	tthh
籩	tthp
筣	ttjj
復	ttjt
稪	ttjt
笿	ttkf
龝	ttmg
篍	ttou
簃	ttqq
篽	ttrb
籞	ttri
筿	ttsu
笗	ttuu
箻	ttvh
篵	ttwh
秝	tty
箞	tudb
徿	tued
籠	tued
穟	tuep
穣	tufe
秚	tufh
籣	tugi
乯	tuhn
従	tuhy
徸	tujf
穜	tujf
簡	tujf
篭	tujn
篰	tukb
箁	tukf
稖	tukg
徶	tumt
乥	tunb
徬	tupy
篣	tupy
筊	tuqu
乊	tur
簅	tutg
衜	tuth
稴	tuvo
鷑	tuwo
稊	tuxt
稵	tuxx
簢	tuyu
節	tvcb
蠞	tvcj
穊	tvcq
笯	tvcu
衟	tvdh
筆	tvfh
徤	tvfp
瓾	tvgn
簫	tvhh
覣	tvhq
箓	tviu
筎	tvkf
簘	tvoj
箒	tvph
犩	tvrh
笂	tvyu
秇	tvyy
笩	twau
彸	twcy
穄	twfi
穥	twfw
籅	twfw
稐	twga
籥	twga
篟	twge
劄	twgj
徻	twgj
箚	twgj
秴	twgk
籲	twgm
箯	twgq
籢	twgt
簽	twgw
籨	twgw
篠	twhs
黐	twic
筗	twkh
稅	twkq
篩	twnh
秹	twtf
筰	twtf
筡	twtu
稌	twty
秂	twu
鵆	twvh
秎	twvn
穒	twvo
聳	twwb
籤	twwg
從	twwh
慫	twwn
熧	twwo
彾	twyc
秢	twyc
笭	twyc
篗	twyc
篒	twye
籂	twyh
衑	twyh
筨	twyk
篬	twyk
笒	twyn
穛	twyo
穕	twys
毎	txfj
瀪	txgi
緐	txgi
勄	txgl
慜	txgn
鰵	txgo
彿	txjh
笰	txjj
箹	txqy
籎	txth
篛	txuu
笓	txxb
稭	txxr
籪	txxr
穖	txxt
穬	tyaw
簱	tyaw
稕	tybg
籬	tyby
勶	tycl
徹	tyct
簔	tyge
笇	tyhu
稤	tyiy
忀	tyke
簑	tyke
笐	tymb
屳	tymj
秔	tymn
肏	tymw
徧	tyna
稨	tyna
笀	tynb
簄	tync
穮	tyno
兦	tynv
籝	tyny
籯	tyny
糴	tyoy
籇	type
込	typi
箷	tytb
籏	tytw
簾	tyuo
筤	tyve
穧	tyvf
穅	tyvi
篖	tyvk
稡	tywf
箤	tywf
鳰	tywo
箊	tywu
衒	tyxh
稸	tyxl
秵	tldy
伳	trff
勧	tdhl
歓	tdhw
紎	thd
臮	thwu
観	tdhq
鿈	tnyy
鿉	tgg
鿟	tjqi
鿠	tjgq
鿯	trqo
劵	udlr
劷	udlt
効	uqlt
勏	uklt
甆	uxxy
甉	uvoy
甋	umdy
疓	uee
痗	utxy
痯	uphn
癅	ugjl
癴	uyxr
癵	uyxw
竕	uwvt
義	ugty
羬	uddy
閍	uye
閥	uwai
瘂	ugfg
閸	ugfg
癋	ugfn
瘻	ulvd
龞	umix
鼈	umix
癠	uyjd
郱	uabh
疘	uad
瘔	uadd
頩	uadm
瘎	uadn
凘	uadr
冮	uag
冴	uaht
疨	uaht
閕	uaht
竎	uaj
戠	uajd
瘄	uajd
癘	uajy
瘽	uakg
閾	uakg
癱	uaky
疶	uanv
艵	uaqc
剙	uavw
剏	uavy
閧	uawi
闀	uawn
鵧	uawo
聞	ubd
癮	uben
兯	ubj
痾	ubsk
愬	ubtn
遡	ubtp
屰	ubtr
欮	ubtw
癊	ubwc
閞	ucak
瘮	ucce
瘆	ucde
闖	uci
凴	ucmb
憑	ucnu
竢	uctd
痠	ucwt
馮	ucy
齹	udab
羢	udad
勌	udbl
閎	udci
羓	udcn
駦	udcu
冹	udcy
竑	udcy
閆	udd
羱	uddi
頖	uddm
羬	uddt
痏	uded
痮	udei
羏	udet
羺	udfj
羵	udfm
羥	udga
羠	udgw
齤	udhb
瘈	udhd
	udi
竰	udjf
竡	udjg
奍	udjj
痷	udjn
閹	udjn
鵥	udjo
劵	udlb
劷	udln
羖	udmc
帣	udmh
巻	udnb
羗	udnc
痝	udne
韏	udnh
羫	udpa
羦	udpq
羜	udps
觠	udqe
鲝	udqg
鮝	udqo
鮺	udqo
	udr
牶	udrh
癧	udth
羴	udud
療	udui
敾	udut
歚	uduw
餋	udwe
瘞	udwf
羭	udwj
瘱	udwn
鴹	udwo
羒	udwv
羷	udww
弮	udxb
絭	udxi
勬	udxl
羪	udye
飬	udye
養	udye
羶	udyg
鯗	udyo
羻	udyt
譱	udyy
閒	ued
顡	uedm
痭	ueed
奨	uefd
醤	uefg
龏	uega
聾	uegb
驡	uegc
礱	uegd
龍	uegd
龑	uegd
龖	uegd
龘	uegd
襲	uege
壟	uegf
龒	uegi
蠪	uegj
鸗	uego
龔	uegw
讋	uegy
覵	uehq
閿	uepc
豙	ueu
疓	uev
凈	uevh
鷳	uewo
闔	ufcl
攱	ufcy
閨	uffd
竍	ufh
癲	ufhm
瘨	ufhw
闐	ufhw
疛	ufi
閈	ufk
闬	ufk
闧	ufkp
癗	ufld
凟	uflm
乧	ufnb
疞	ufnv
痚	uftb
閉	ufte
瘏	uftj
闍	uftj
阇	uftj
闥	ufup
闚	ufwq
癨	ufwy
開	ugak
癅	ugal
痓	ugcf
閂	ugd
閏	ugd
凊	ugeg
痡	ugey
	ugf
瘂	ughg
閸	ughg
疜	ughi
閇	ughi
慿	ughn
癋	ughn
羨	ugiw
竱	ugjf
凍	ugji
闘	ugkf
竵	ugkh
凁	ugki
癩	ugkm
瘷	ugkt
瘶	ugkw
闌	ugli
羙	ugou
羮	ugoy
羑	ugqy
義	ugtt
閛	uguh
痙	ugva
羛	ugxj
羕	ugyi
閠	ugyi
瘧	uhag
闃	uhdi
闅	uhhc
竨	uhjh
痁	uhkd
門	uhng
痟	uied
閖	uii
閯	uiit
闛	uipf
闣	uipl
闊	uitd
竗	uitt
頀	ujac
韺	ujad
贑	ujam
戅	ujan
韷	ujbm
間	ujd
勭	ujfl
氃	ujfn
韴	ujgh
瘍	ujgr
痩	ujhc
覸	ujhq
痋	uji
閩	uji
閶	ujjd
韻	ujkm
竜	ujnb
闒	ujnd
阘	ujnd
鷾	ujno
遧	ujpk
竸	ujqq
痬	ujqr
嬜	ujqv
韹	ujrg
韸	ujth
贛	ujtm
戇	ujtn
韼	ujtp
竷	ujtt
鶕	ujwo
鷼	ujwo
閺	ujyi
問	ukd
袞	ukeu
咅	ukf
瘻	ukgv
竒	ukhj
闠	ukhm
阓	ukhm
郶	ukkc
閭	ukkd
癉	ukkf
闡	ukkf
闆	ukkk
勏	ukln
兗	ukqb
競	ukqq
敚	ukqt
敨	ukty
疻	ukwi
兾	ulaw
凅	uldg
凙	ulff
癦	ulff
癏	ulge
闤	ulge
阛	ulge
瘝	ulii
鄫	uljb
曽	uljf
朆	uljr
閘	ulk
閳	ulk
痐	ulkd
癳	ulli
閫	ulsi
辦	uluh
癑	umae
闦	umau
痶	umaw
竐	umcy
啇	umdf
甋	umdn
適	umdp
敵	umdt
歒	umdw
痌	umgk
凒	umgu
闓	umgu
閴	umi
鄨	umic
獘	umid
龞	umig
幣	umih
暼	umij
蟞	umij
鱉	umio
鷩	umio
鐅	umiq
撆	umir
嫳	umiv
鼈	umiv
彆	umix
斃	umix
閊	umk
癭	ummv
竌	umn
瘑	umnk
闿	umnv
闝	umti
瘋	umtj
闏	umtj
颯	umtj
凗	umwy
冺	unan
闞	unbt
瘺	unfi
闈	unhh
悶	uni
闢	unku
乵	unn
閟	unte
竮	unua
疦	unwi
痆	unxv
並	uogf
焛	uoi
疢	uoi
癆	uool
竤	updc
竩	upeg
凕	upju
瘒	uplk
鶙	upmo
遆	upmp
痯	upnn
竚	upsh
覫	upyq
痻	uqaj
閽	uqaj
疧	uqav
疷	uqay
頝	uqdm
癚	uqdy
螀	uqfj
凎	uqg
虠	uqhm
痀	uqkd
竘	uqkg
凂	uqkq
効	uqln
瘓	uqmd
癬	uqod
	uqqg
痑	uqqi
瘹	uqqy
閻	uqvd
竫	uqvh
	uqvh
	uqvh
餈	uqwe
垐	uqwf
資	uqwm
乲	uqwn
鵁	uqwo
栥	uqws
楶	uqws
秶	uqwt
痸	urmj
瘣	urqc
痺	urtf
兿	urvc
兠	urxq
閪	usd
闉	usfd
凐	usfg
痲	usfq
鄭	usgb
蠤	usgj
鷷	usgo
親	ushq
閑	usi
閅	usk
閜	uskd
凚	ussi
痳	ussi
凓	ussy
闄	usvd
鷴	uswo
竔	utah
凞	utao
痵	utbd
閁	ute
顔	utem
遃	utep
竏	utfh
竓	utfn
閐	utfn
閮	utfp
瘇	utgf
癪	utgm
癟	utha
導	uthf
噵	uthk
瘜	uthn
闑	uths
閣	utkd
竬	utky
癓	utmt
癥	utmt
竧	utmt
痜	utmv
疺	utpi
産	uttg
剷	uttj
癁	uttt
癤	utvb
亷	utvo
瘲	utwh
痗	utxu
瘚	uubw
闕	uubw
閚	uud
闁	uud
闂	uudb
癢	uude
関	uudi
癇	uued
冸	uufh
閗	uufk
竝	uug
辡	uuh
瘖	uujd
癎	uujd
闇	uujd
暜	uujf
痥	uukq
閲	uukq
竲	uulj
竴	uusf
閰	uvd
冿	uvfh
疩	uvfk
癰	uvky
癙	uvnn
甉	uvon
鶼	uvoo
辧	uvuh
閥	uwae
闋	uwgd
瘉	uwgj
癐	uwgj
冾	uwgk
閤	uwgk
癒	uwgn
闟	uwgn
竳	uwgu
閃	uwi
閱	uwkq
鹢	uwlg
鷁	uwlo
凃	uwty
竕	uwvn
鴗	uwvo
	uwwf
	uwwf
疭	uwwi
閦	uwww
癈	uwxc
閄	uwy
竛	uwyc
閝	uwyc
痽	uwyd
閵	uwyd
飡	uwye
凖	uwyf
凔	uwyk
瘡	uwyk
癄	uwyo
瘬	uxde
鄁	uxeb
丠	uxgf
弚	uxhj
鵜	uxho
辮	uxiu
疿	uxjk
軰	uxlj
癡	uxth
疕	uxv
關	uxxg
甆	uxxn
闗	uxxo
鶿	uxxo
鷀	uxxo
疪	uxxv
癴	uxyr
癵	uxyw
訚	uyd
誾	uyd
閔	uyi
凉	uyiy
癝	uyli
凜	uylt
癛	uylt
閙	uymh
閌	uymv
闙	uynk
痎	uynw
閡	uynw
丷	uyt
瘯	uytd
辬	uyuh
辯	uyuh
閍	uyv
閬	uyve
癠	uyvf
閼	uywu
癕	uyxy
闎	urii
羳	udtl
龹	ufw
龹	udu
鿑	ugyy
鿛	ufwq
鿪	uepo
刕	vvvr
嚳	vqqk
壆	vqqf
妢	vwvt
娍	vdny
娒	vtxy
娚	vllt
娷	vtfg
婔	vhdd
婠	vphn
媙	vdgy
嬟	vugy
嬩	vvgw
嬹	vvmw
嬿	vako
學	vqqb
嶨	vqqm
擧	vgnr
斅	vqqc
斆	vqqt
歟	vgnw
澩	vqqi
燢	vqqo
爂	vmgo
礐	vqqd
礜	vgnd
臖	vmge
與	vgnw
興	vmgw
舉	vgnh
舋	vmgg
覺	vqqq
觷	vqqe
譽	vgny
輿	vlgw
轝	vgnl
辺	vpe
釁	vmgv
雤	vqqy
鱟	vqqo
鷽	vqqo
鸒	vgno
黌	vqqw
肅	vfjk
鷫	vfjo
歗	vfjw
婭	vgfg
婣	vjgg
嫟	vaak
嬺	vaan
媶	vabg
婼	vadk
媅	vadn
娀	vadt
娸	vadw
姏	vafg
妅	vag
嬅	vagf
姫	vahh
鄩	vakb
彠	vakc
尋	vakf
嫤	vakg
嫗	vakk
嫨	vakw
孉	vaky
媌	valg
媖	vamd
嫹	vamw
姖	vang
媟	vans
嬞	vatf
嫕	vatn
孏	vaui
嬿	vauo
嬳	vawc
婲	vawx
娂	vawy
娵	vbcy
嫷	vbde
邚	vbh
恏	vbnu
塈	vcaf
鱀	vcao
堲	vcbf
媃	vcbs
娺	vccc
駑	vccu
砮	vcdf
姢	vceg
妑	vcn
拏	vcrj
娭	vctd
厹	vcu
鴑	vcwo
鵖	vcwo
媽	vcy
媠	vdae
妭	vdcy
姷	vdeg
媩	vdeg
娾	vdff
媷	vdff
姱	vdfn
妬	vdg
媙	vdgt
妦	vdhh
夓	vdht
婔	vdjd
媆	vdmd
媔	vdmd
頄	vdmy
娏	vdne
娍	vdnt
娔	vdqn
嫄	vdri
婍	vdsk
嫴	vduh
嫽	vdui
媋	vdwj
嫀	vdwt
娐	vebg
嬡	vept
媱	verm
婇	vesy
婬	vetf
嬀	veto
娞	vevg
嫍	vevg
彟	vfac
妘	vfcy
嬬	vfdj
嫮	vffn
嬈	vffq
衋	vfhl
嫃	vfhw
卆	vfj
書	vfjf
晝	vfjg
妌	vfjh
媴	vfke
嬯	vfkf
姞	vfkg
畵	vflb
畫	vflg
劃	vflj
嬻	vflm
毀	vfmc
婻	vfmf
嬦	vfnf
娡	vfny
嬄	vfpu
妧	vfqn
姸	vftf
媎	vftj
婞	vfuf
嬙	vfwk
婈	vfwt
妋	vfwy
娬	vgah
姪	vgcf
婖	vgdn
姃	vghg
婭	vghg
娝	vgik
妚	vgiy
嫥	vgjf
姮	vgjg
娻	vgji
娪	vgkg
娕	vgki
嬾	vgkm
嫰	vgkw
婳	vglb
媡	vgli
姉	vgmh
孋	vgmx
嫧	vgmy
舃	vgno
煭	vgqo
妺	vgsy
娙	vgva
嬭	vgwq
嫊	vgxi
嫭	vhah
婋	vham
虓	vham
鄋	vhcb
遚	vhcp
	vhgd
盡	vhgl
賮	vhgm
婌	vhic
婥	vhjh
媜	vhmy
娊	vhqn
肅	vhth
鷫	vhto
歗	vhtw
媫	vhvh
娋	vieg
鹔	vijg
盝	vilf
姯	viqn
媣	vivs
娨	vjfh
媞	vjgh
婸	vjgr
媢	vjhg
妽	vjhh
嫚	vjlc
媀	vjmy
鄛	vjsb
勦	vjsl
婐	vjsy
婫	vjxx
卲	vkbh
綤	vkbi
雝	vkcy
叴	vkf
妕	vkhh
嬇	vkhm
娖	vkhy
刟	vkjh
嬋	vkkf
嬠	vkks
孍	vkkt
帤	vkmh
娛	vknd
巶	vknn
娯	vknw
欩	vkqw
挐	vkrj
桇	vksu
鴽	vkwo
婟	vldg
媦	vleg
嬕	vlff
嫼	vlfo
嬛	vlge
疀	vlgh
嬽	vlhd
娚	vlln
嫐	vllv
媤	vlny
巤	vlqn
媼	vlwl
鶅	vlwo
姍	vmah
婰	vmaw
婩	vmdf
媏	vmdj
姎	vmdy
姌	vmfg
婤	vmfk
姵	vmgh
姛	vmgk
媺	vmgt
嬍	vmgt
奾	vmh
帠	vmhj
帇	vmhk
孆	vmmv
媧	vmnk
孈	vmwk
妠	vmwy
姄	vnan
婮	vndg
媉	vngf
婽	vnhc
媁	vnhh
孎	vnij
妼	vntt
鼥	vnuc
鼣	vnud
鼫	vnud
鼳	vnud
鼵	vnud
鼱	vnue
鼭	vnuf
鼪	vnug
鼦	vnuk
鼩	vnuk
鼲	vnul
鼺	vnul
鼰	vnum
鼶	vnum
鼸	vnuo
鼮	vnup
鼨	vnuu
鼴	vnuv
鼧	vnux
鼤	vnuy
嫪	vnwe
妜	vnwy
嬥	vnwy
粛	vojk
毇	vomc
嬫	voos
婒	vooy
嫾	voqh
災	vou
彛	vowa
彞	voxa
婃	vpfi
媗	vpgg
婝	vpgh
嬪	vpgm
彚	vpjs
嫇	vpju
媈	vplh
婠	vpnn
嬣	vpns
妉	vpqn
嬸	vptl
廵	vpv
辺	vpv
姲	vpvg
嫆	vpwk
兒	vqb
郳	vqbh
媰	vqbt
姽	vqdb
妳	vqiy
姰	vqjg
姁	vqkg
姳	vqkg
嬎	vqkg
嬔	vqkg
婏	vqky
嫓	vqmx
媍	vqmy
婅	vqoy
姼	vqqy
夛	vqu
婙	vqvh
鶂	vqwo
嬼	vqyj
媹	vqyl
奺	vqyy
媓	vrgg
姤	vrgk
娦	vrgw
妡	vrh
姩	vrhf
嫵	vrlo
婂	vrmh
媿	vrqc
妷	vrwy
嬓	vryt
奵	vsh
妸	vskg
婹	vsvg
婡	vsww
雑	vswy
奼	vtan
姡	vtdg
嬌	vtdk
奷	vtfh
娗	vtfp
姺	vtfq
娷	vtgf
媑	vtgf
妰	vthf
婣	vthh
嬶	vthj
娫	vthp
娳	vtjh
羣	vtkd
裠	vtke
帬	vtkh
頵	vtkm
焄	vtko
鵘	vtko
覠	vtkq
姠	vtmk
嬏	vtol
姂	vtpy
婑	vtvg
孂	vtvl
娒	vtxu
姀	vty
嬂	vuaj
嫅	vuda
婘	vudb
嫸	vudk
嫺	vueg
媊	vuej
嬘	vuep
嬢	vufe
姅	vufh
媄	vugd
孄	vugi
嬟	vugt
嬑	vujn
婄	vukg
娧	vukq
媂	vuph
嫎	vupy
媨	vusg
媇	vusy
嫻	vusy
嬨	vuxn
嫿	vvfg
姧	vvfh
奻	vvg
嬧	vvhl
娽	vviy
妱	vvkg
婦	vvph
婗	vvqn
刕	vvvb
脋	vvve
姦	vvvf
妐	vwcy
嬩	vwfw
嬹	vwfw
婨	vwga
媕	vwga
婾	vwgb
姾	vwgg
媮	vwgj
嬒	vwgj
姶	vwgk
嬆	vwgn
嬁	vwgu
嬐	vwgw
刅	vwi
妎	vwjh
媬	vwks
惥	vwnu
娰	vwnw
姙	vwtf
斞	vwuf
嬝	vwve
妢	vwvn
鳩	vwvo
鳭	vwvo
孅	vwwg
姈	vwyc
孇	vwyc
婎	vwyg
娢	vwyk
嫶	vwyo
嬵	vxrh
嫋	vxuu
蠿	vxxj
媘	vxxr
娹	vxyx
嫬	vyao
訄	vyd
娮	vyg
丒	vygf
妵	vygg
刄	vyi
婛	vyiy
妔	vymn
媥	vyna
姟	vynw
孊	vysd
嫲	vyss
嬤	vysx
嫙	vyth
媯	vyto
嬚	vyuo
嫏	vyvb
奿	vyvd
嫞	vyvh
歰	vyvh
嫝	vyvi
妶	vyxy
妏	vyy
鿻	vnuh
鿼	vnuk
侽	wllt
俴	waay
倕	wtfg
傶	wdhy
僟	wxxy
儀	wugy
儍	wobt
瓫	wvgy
癶	wnyy
雋	wyhm
餆	wpqi
餓	wpty
饑	wpxy
饖	wphy
鸃	wvgy
夓	wfdt
盥	wfil
俹	wgfg
僫	wgfn
餞	wpaa
饃	wpad
饛	wpae
饉	wpag
饇	wpak
饚	wpal
餀	wpaq
饊	wpat
餝	wpay
餌	wpbg
飿	wpbm
餟	wpcc
飴	wpck
餕	wpct
餴	wpda
餪	wpdd
餦	wpde
餬	wpde
餣	wpdn
飷	wpeg
餒	wpev
饀	wpev
餑	wpfb
飦	wpfh
饎	wpfk
饁	wpfl
饙	wpfm
饒	wpfq
饐	wpfu
饢	wpge
餺	wpgf
餗	wpgi
飩	wpgn
餖	wpgu
餔	wpgy
饖	wpht
饄	wpif
餆	wpiq
饓	wpis
饅	wpjc
饆	wpjf
饂	wpjl
餲	wpjn
餳	wpjr
餜	wpjs
餛	wpjx
饋	wpkm
餵	wple
饠	wply
餶	wpme
餇	wpmk
飢	wpmn
飼	wpnk
飶	wpnt
饌	wpnw
餤	wpoo
餫	wppl
館	wppn
飹	wpqb
餚	wpqe
餙	wpqh
餾	wpql
飽	wpqn
餡	wpqv
飲	wpqw
饞	wpqy
飯	wprc
餽	wprc
餭	wprg
餼	wpro
餷	wpsg
飣	wpsh
飥	wpta
飫	wptd
餂	wptd
飪	wptf
飵	wptf
餠	wptf
飾	wpth
餰	wpth
餉	wptk
餎	wptk
飭	wptl
饡	wptm
餓	wptt
餧	wptv
飠	wpu
餅	wpua
饈	wpuf
餢	wpuk
饍	wpuk
餻	wpuo
餸	wpup
餃	wpuq
餿	wpvc
餱	wpwd
飻	wpwe
餁	wpwf
餄	wpwk
餘	wpwt
餩	wpww
飤	wpwy
餯	wpxe
饑	wpxt
饝	wpyd
餏	wpye
饟	wpye
飳	wpyg
饘	wpyg
飰	wpyh
餹	wpyk
僶	wxg
儕	wyjg
侙	waag
僷	waas
俴	waat
傇	wabg
偡	wadn
倛	wadw
僛	wadw
儰	waeo
垈	waff
佄	wafg
仜	wag
仺	wagf
儖	wahl
僅	wakg
傴	wakk
傼	wakw
儺	waky
儚	walq
偀	wamd
帒	wamh
貸	wamu
僙	wamw
伳	wann
偞	wans
僃	waqe
僀	waqh
柋	wasu
備	wate
憊	watn
倻	wbbh
怹	wbnu
鸧	wbqg
伃	wcbh
僪	wcbk
傪	wcce
頌	wcdm
佁	wckg
鹟	wcng
勜	wcnl
鶲	wcno
忩	wcnu
兊	wcqb
毤	wcqn
枀	wcsu
仏	wcy
傌	wcy
伌	wdbn
伖	wdcy
優	wdet
倀	wdey
倴	wdfa
侲	wdfe
傉	wdff
倷	wdfi
佦	wdg
侟	wdhb
偰	wdhd
仹	wdhh
傶	wdht
偄	wdmd
偭	wdmd
佈	wdmh
侕	wdmj
偧	wdqq
傸	wdqq
傆	wdri
儮	wdth
傄	wduh
偆	wdwj
俠	wdww
俷	wecn
倗	weeg
仴	weg
伹	wegg
偁	wemf
僢	weph
僾	wept
傜	werm
倸	wesy
僞	weto
俀	wevg
傒	wexd
伋	weyy
傤	wfal
儎	wfal
僨	wfam
伝	wfcy
佉	wfcy
僥	wffq
礜	wfgd
舉	wfgh
轝	wfgl
鸒	wfgo
擧	wfgr
歟	wfgw
與	wfgw
譽	wfgy
仠	wfh
佱	wfhf
値	wfhn
傎	wfhw
佅	wfiy
仐	wfj
癷	wfj
傋	wfjf
儓	wfkf
舎	wfkf
舘	wfkn
鵨	wfko
舖	wfky
舗	wfky
儥	wflm
輿	wflw
臖	wfme
舋	wfmg
爂	wfmo
釁	wfmv
興	wfmw
儔	wfnf
怤	wfnu
俧	wfny
侼	wfpb
學	wfqb
発	wfqb
斅	wfqc
礐	wfqd
觷	wfqe
壆	wfqf
澩	wfqi
嚳	wfqk
嶨	wfqm
燢	wfqo
鱟	wfqo
鷽	wfqo
覺	wfqq
斆	wfqt
黌	wfqw
雤	wfqy
侾	wftb
偖	wftj
侤	wftn
倖	wfuf
姇	wfvf
僣	wfwj
儧	wfwm
倰	wfwt
伕	wfwy
倵	wgah
侀	wgaj
伅	wgbn
戣	wgda
鄈	wgdb
兪	wgeb
鄃	wgeb
儬	wgeq
覦	wgeq
歈	wgew
俌	wgey
俵	wgey
亼	wgf
仼	wgg
佂	wghg
俹	wghg
僫	wghn
傿	wgho
伾	wgig
俖	wgik
伓	wgiy
傳	wgjf
倲	wgji
僡	wgjn
弇	wgka
郃	wgkb
鄧	wgkb
敆	wgkc
龕	wgkd
儾	wgke
俉	wgkg
倳	wgkh
龣	wgki
剣	wgkj
劍	wgkj
樖	wgkk
偪	wgkl
畣	wgkl
盫	wgkl
頜	wgkm
顩	wgkm
龥	wgkm
翖	wgkn
鴿	wgko
鸙	wgko
邆	wgkp
覴	wgkq
搻	wgkr
龤	wgkr
斂	wgkt
龢	wgkt
侸	wgku
豋	wgku
劎	wgkv
僉	wgkw
欱	wgkw
歛	wgkw
龡	wgkw
剱	wgky
劒	wgky
劔	wgky
鄶	wglb
朇	wglf
劊	wglj
會	wglj
侖	wgma
侢	wgmf
伂	wgmh
傮	wgmj
儷	wgmx
倆	wgmy
債	wgmy
侴	wgnj
俫	wgoy
伻	wguh
俓	wgva
倢	wgvh
儞	wgwq
仾	wgxg
傃	wgxi
侇	wgxw
俿	wham
儢	whan
佊	whcy
仩	whg
倶	whgw
俶	whic
佔	whkg
偵	whmy
佀	whnn
俔	whqn
儏	whqo
脩	whte
鞗	whtf
跾	whth
絛	whti
偹	whtl
翛	whtn
倐	whto
儵	whto
焂	whto
鯈	whto
鋚	whtq
鎥	whtq
條	whts
偼	whvh
佌	whxn
偨	whxs
僘	wimt
儅	wipl
償	wipm
儻	wipo
侊	wiqn
偗	with
仯	witt
尒	wiu
仦	wiy
儤	wjai
偍	wjgh
偒	wjgr
敒	wjht
僈	wjlc
傝	wjng
儑	wjxo
倱	wjxx
偮	wkbg
俋	wkcn
侱	wkgg
僓	wkhm
儙	wkhp
僤	wkkf
偘	wkkk
偔	wkkn
僺	wkks
儼	wkkt
傊	wkmy
俁	wknd
兌	wkqb
敓	wkqt
諐	wkqy
賲	wksm
侶	wktk
伿	wkwy
個	wldg
伵	wlg
伡	wlh
俥	wlh
佪	wlkg
儽	wlli
侽	wlln
偲	wlny
僆	wlpy
僌	wlty
僂	wlvg
傫	wlxi
儸	wlxy
儂	wmae
僼	wmau
倎	wmaw
癹	wmcu
伇	wmcy
偳	wmdj
佒	wmdy
傰	wmee
傦	wmeg
伷	wmg
僶	wmgv
仚	wmj
側	wmjh
儩	wmjr
伣	wmqn
偑	wmtj
儶	wmwk
侺	wmwn
僝	wnbb
鄔	wngb
偓	wngf
烏	wngo
歍	wngw
偦	wnhe
偉	wnhh
帥	wnnh
師	wnnh
歸	wnnh
蛗	wnnj
侷	wnnk
峊	wnnm
頧	wnnm
顊	wnnm
鴭	wnno
僎	wnnw
鄇	wntb
佖	wntt
偋	wnua
亾	wnv
僇	wnwe
伈	wny
癶	wnyt
侭	wnyu
伬	wnyy
僕	wogy
僗	wool
儝	woos
倓	wooy
僯	woqh
侎	woy
傢	wpey
僿	wpff
倧	wpfi
俒	wpfq
儐	wpgm
蝕	wpjy
伔	wpmn
儜	wpns
倇	wpqb
佇	wpsh
俕	wpsy
侘	wpta
侒	wpvg
傛	wpwk
僒	wpwk
傕	wpwy
傑	wqas
尣	wqb
爺	wqbb
	wqbt
佹	wqdb
倄	wqde
俙	wqdh
釡	wqf
尩	wqgd
侚	wqjg
佲	wqkg
俛	wqkq
儳	wqky
偩	wqmy
佨	wqnn
儍	wqot
尦	wqqy
伆	wqrt
俇	wqtg
伨	wqug
	wqvg
仢	wqyy
仮	wrcy
偱	wrfh
偟	wrgg
伒	wrh
傂	wrhm
儛	wrlh
俽	wrqw
儨	wrrm
儌	wryt
僊	wsdn
僄	wsfi
価	wsg
價	wsmy
恷	wsnu
烋	wsou
僲	wsqh
儊	wssh
僸	wssi
偠	wsvg
倯	wswc
鵂	wswo
倈	wsww
佭	wtah
仛	wtan
俬	wtcy
佸	wtdg
倁	wtdk
僑	wtdk
仸	wtdy
俢	wtet
侜	wtey
倂	wtff
偫	wtff
俈	wtfk
儹	wtfm
賃	wtfm
鵀	wtfo
侹	wtfp
侁	wtfq
栠	wtfs
偛	wtfv
倕	wtgf
偅	wtgf
働	wtgl
敍	wthc
偺	wthj
倃	wthk
傷	wtjr
佫	wtkg
俰	wtkg
偊	wtky
畬	wtlf
侐	wtlg
俻	wtlg
傯	wtln
峹	wtmj
嵞	wtmm
悆	wtnu
僠	wtol
僁	wton
僽	wton
偢	wtoy
敘	wtty
厁	wtub
傱	wtwh
雓	wtwy
併	wuah
傞	wuda
儯	wudc
僐	wudk
儱	wued
僩	wueg
偂	wuej
們	wug
儀	wugt
偣	wujg
僴	wujg
傽	wujh
億	wujn
傹	wujq
侻	wukq
偙	wuph
俲	wuql
傚	wuqt
佽	wuqw
僔	wusf
偤	wusg
儭	wusq
偐	wute
仒	wuu
傡	wuug
倿	wuvg
傔	wuvo
偝	wuxe
俤	wuxt
弅	wvaj
邠	wvbh
伮	wvcy
頒	wvdm
佷	wvey
伜	wvfh
侓	wvfh
鴏	wvga
鵿	wvga
鄡	wvgb
鄥	wvgb
鷌	wvgc
鸌	wvgc
裊	wvge
鶳	wvgh
鵦	wvgi
鸔	wvgi
鴚	wvgk
鴼	wvgk
鳨	wvgl
島	wvgm
鳧	wvgm
鳬	wvgm
鷈	wvgm
瓫	wvgn
鳦	wvgn
鳥	wvgo
鶃	wvgq
梟	wvgs
鵌	wvgt
鵔	wvgt
鷻	wvgt
鸃	wvgt
鴤	wvgu
鴃	wvgw
鴥	wvgw
鶀	wvgw
鴕	wvgx
鵻	wvgy
傁	wvhc
儘	wvhl
蚠	wvju
佋	wvkg
侞	wvkg
兺	wvkx
儠	wvln
貧	wvmu
炃	wvou
侰	wvtk
攽	wvty
鳻	wvwo
麄	wvyx
仭	wvyy
韱	wwag
倊	wwcn
傟	wwcn
伀	wwcy
剉	wwfj
倽	wwfk
夎	wwft
倫	wwga
偸	wwgb
佺	wwgg
儈	wwgj
佮	wwgk
僜	wwgu
倹	wwgw
儉	wwgw
睂	wwhh
伱	wwiy
谾	wwka
卻	wwkb
郤	wwkb
谹	wwkc
豀	wwkd
豅	wwkd
豂	wwke
螸	wwkj
谽	wwkk
豄	wwkm
慾	wwkn
鵒	wwko
逧	wwkp
谺	wwkt
谻	wwkt
豃	wwkt
谼	wwkw
佡	wwmh
俆	wwty
仌	wwu
侳	wwwf
傘	wwwf
仈	wwy
倠	wwyg
傖	wwyk
僋	wwym
儁	wwym
仱	wwyn
傾	wxdm
伄	wxhh
發	wxmc
貨	wxmu
儗	wxth
僟	wxxt
儣	wyaw
俼	wyce
鸰	wycg
刢	wycj
領	wycm
鴒	wyco
隻	wycu
顀	wydm
偯	wyey
詧	wyf
儲	wyfj
鶽	wyfo
傠	wyfy
倞	wyiy
儴	wyke
儃	wylg
傐	wymk
雋	wymm
侌	wync
酓	wyng
韽	wynj
盦	wynl
貪	wynm
頷	wynm
傓	wynn
儦	wyno
鳹	wyno
敜	wynt
侫	wynv
侅	wynw
欦	wynw
僱	wyny
雂	wyny
顦	wyom
鷦	wyoo
進	wypd
儫	wype
燞	wyqo
侂	wyta
偽	wyto
倣	wyty
亽	wyu
戧	wyva
餞	wyva
餴	wyva
餅	wyva
餌	wyvb
餑	wyvb
飹	wyvb
飯	wyvc
飠	wyvc
饅	wyvc
餟	wyvc
餽	wyvc
餿	wyvc
饃	wyvd
餪	wyvd
飫	wyvd
餂	wyvd
餱	wyvd
饝	wyvd
俍	wyve
饛	wyve
餦	wyve
餬	wyve
饢	wyve
餵	wyve
餶	wyve
餚	wyve
飻	wyve
餯	wyve
餏	wyve
饟	wyve
儕	wyvf
飦	wyvf
餺	wyvf
饄	wyvf
饆	wyvf
飪	wyvf
飵	wyvf
餠	wyvf
饈	wyvf
餁	wyvf
饉	wyvg
飷	wyvg
餭	wyvg
餷	wyvg
飳	wyvg
饘	wyvg
傭	wyvh
餙	wyvh
飾	wyvh
餰	wyvh
飰	wyvh
餗	wyvi
創	wyvj
倉	wyvk
傏	wyvk
饇	wyvk
飴	wyvk
饎	wyvk
餇	wyvk
飼	wyvk
餉	wyvk
餎	wyvk
餢	wyvk
饍	wyvk
餄	wyvk
餹	wyvk
饚	wyvl
饁	wyvl
饂	wyvl
餫	wyvl
餾	wyvl
飭	wyvl
飿	wyvm
饙	wyvm
饋	wyvm
飢	wyvm
饡	wyvm
餣	wyvn
飩	wyvn
餲	wyvn
館	wyvn
飽	wyvn
飥	wyvn
鶬	wyvo
餤	wyvo
餼	wyvo
餻	wyvo
餸	wyvp
餀	wyvq
饒	wyvq
餆	wyvq
餃	wyvq
餳	wyvr
饓	wyvs
餜	wyvs
飣	wyvs
饊	wyvt
餕	wyvt
饖	wyvt
飶	wyvt
餓	wyvt
餘	wyvt
饑	wyvt
饐	wyvu
餖	wyvu
餒	wyvv
饀	wyvv
餡	wyvv
餧	wyvv
飮	wyvw
饌	wyvw
飲	wyvw
餩	wyvw
飤	wyvw
餛	wyvx
餝	wyvy
餔	wyvy
饠	wyvy
饞	wyvy
雙	wywc
倅	wywf
犨	wywh
雧	wyws
讐	wywy
雔	wywy
雥	wywy
雦	wywy
傗	wyxl
伭	wyxy
伩	wyy
犫	wyyh
讎	wyyy
佀	wnhn
飠	wyvy
鿇	wqvh
鿖	wgkg
鿗	wwvg
鿘	wvtk
鿙	wvtq
鿚	wvtk
鿪	weyo
幾	xxdy
毑	xyyb
糼	xlt
糿	xvt
紐	xnhf
紛	xwvt
紡	xyt
絏	xjnt
絩	xqiy
絾	xdny
綉	xtet
綞	xtfg
綫	xaay
綰	xphn
緋	xhdd
緘	xdgy
縅	xdgy
縬	xdhy
繉	xhqi
纅	xrxs
纞	xyxn
袰	xyye
鄳	xbh
黽	xhng
縷	xlvg
彇	xvfj
繡	xvfj
繩	xxg
緕	xyjg
纃	xyjg
綫	xaat
縙	xabg
絨	xadt
綨	xadw
繖	xaet
紺	xafg
緙	xafh
紅	xag
弫	xahh
弬	xahh
繿	xahl
纜	xahq
縸	xajd
緎	xakg
彄	xakk
緢	xalg
緓	xamd
绬	xamd
彉	xamw
弡	xang
紲	xann
弽	xans
緤	xans
繱	xaqn
纄	xatp
緅	xbcy
弢	xbhc
絀	xbmh
紓	xcbh
繘	xcbk
綴	xccc
縿	xcce
縔	xccs
経	xcfg
強	xcjy
紿	xckg
緿	xckn
弝	xcn
紦	xcn
紁	xcyy
紘	xdcy
紱	xdcy
纮	xdcy
絠	xdeg
纋	xdet
張	xdey
縟	xdff
絝	xdfn
緘	xdgt
縅	xdgt
縬	xdht
緋	xdjd
緾	xdjf
絔	xdjg
緛	xdmd
緬	xdmd
頃	xdmy
紌	xdnn
絾	xdnt
縓	xdri
綺	xdsk
綁	xdtb
繚	xdui
縥	xdwt
綊	xdww
紎	xdy
綒	xebg
弸	xeeg
綳	xeeg
絼	xeet
緩	xefc
組	xegg
剶	xejh
劙	xejj
盠	xelf
綬	xepc
綵	xesy
綏	xevg
縚	xevg
鶨	xewo
縘	xexd
級	xeyy
繊	xfag
纎	xfag
紜	xfcy
紶	xfcy
駂	xfcy
繻	xfdj
繧	xffc
絓	xffg
繞	xffq
縝	xfhw
頴	xfim
颕	xfim
絿	xfiy
毌	xfk
結	xfkg
繥	xfkk
纈	xfkm
續	xflm
遦	xfmp
貫	xfmu
綕	xfny
綍	xfpb
続	xfpq
緒	xftj
緖	xftj
緈	xfuf
盭	xful
繨	xfup
繬	xfwk
纉	xfwm
鴇	xfwo
綾	xfwt
紂	xfy
純	xgbn
絰	xgcf
绖	xgcf
緻	xgct
彑	xgd
縛	xgef
綪	xgeg
弖	xgf
弙	xgfh
紆	xgfh
絚	xghg
剝	xgij
彔	xgiu
紑	xgiy
縳	xgjf
絙	xgjg
繐	xgjn
綆	xgjq
綀	xgki
彊	xglg
繮	xglg
練	xgli
弻	xglx
纚	xgmx
緉	xgmy
績	xgmy
彜	xgoa
縉	xgoj
彙	xgps
毑	xgub
袰	xgue
弳	xgva
經	xgva
緁	xgvh
緀	xgvv
彌	xgwq
瓕	xgwy
縤	xgxi
纑	xhal
紴	xhcy
彏	xhhc
繉	xhiq
緲	xhit
綽	xhjh
弔	xhk
盄	xhlf
緽	xhmy
顚	xhnm
鷆	xhno
眞	xhnw
絸	xhqn
紪	xhxn
潁	xidm
弰	xieg
綃	xieg
弾	xijf
緔	ximk
絖	xiqn
絩	xiqn
紗	xitt
彃	xjaf
縪	xjaf
繓	xjbc
緹	xjgh
紳	xjhh
縨	xjiq
刜	xjjh
縄	xjjn
縵	xjlc
緼	xjlg
缊	xjlg
鄪	xjmb
費	xjmu
緆	xjqr
綶	xjsy
鴲	xjwo
絏	xjxt
緄	xjxx
緝	xkbg
弲	xkeg
絹	xkeg
縷	xkgv
紃	xkh
繢	xkhm
繾	xkhp
勥	xkjl
謽	xkjy
彈	xkkf
繟	xkkf
絽	xkkg
繰	xkks
縜	xkmy
孧	xlbf
絪	xldy
緭	xleg
繹	xlff
纆	xlff
細	xlg
彋	xlge
繯	xlge
綥	xlgj
絗	xlkg
纝	xlli
糼	xln
緦	xlny
縺	xlpy
綑	xlsy
縕	xlwl
鴢	xlwo
縲	xlxi
轡	xlxk
纙	xlxy
繷	xmae
紻	xmdy
繃	xmee
縎	xmeg
綢	xmfk
紬	xmg
	xmg
絧	xmgk
繩	xmgv
絅	xmkg
纓	xmmv
緺	xmnk
綱	xmum
網	xmun
綗	xmwk
纗	xmwk
納	xmwy
繀	xmwy
緡	xnaj
紐	xnfg
緪	xngg
縆	xngg
縀	xnhc
縃	xnhe
糾	xnhh
緯	xnhh
乣	xnn
糺	xnn
紀	xnn
繏	xnnw
糹	xnny
繆	xnwe
熲	xodm
颎	xodm
継	xonn
緂	xooy
繗	xoqh
綋	xpdc
縖	xpdk
綜	xpfi
綄	xpfq
縇	xpgg
纻	xpgg
綻	xpgh
繽	xpgm
縯	xpgw
緷	xplh
綰	xpnn
綩	xpqb
紞	xpqn
紵	xpsh
縡	xpuh
縮	xpwj
紽	xpxn
緍	xqaj
紙	xqan
弤	xqay
緵	xqbt
縐	xqbt
絶	xqcn
絺	xqdh
繎	xqdo
繲	xqeh
絢	xqjg
絇	xqkg
絻	xqkq
纔	xqky
綯	xqrm
绹	xqrm
緫	xqrn
繺	xqvo
弞	xqwy
約	xqyy
絈	xrg
紤	xrh
絑	xriy
線	xriy
缐	xriy
綿	xrmh
綼	xrtf
紩	xrwy
樂	xrxs
繳	xryt
緸	xsfg
縹	xsfi
絤	xsg
絊	xsgg
綇	xsgg
糽	xsh
緗	xshg
彁	xskk
綝	xssy
絉	xsyy
絳	xtah
鄊	xtbb
絁	xtbn
觺	xtde
絬	xtdg
綘	xtdh
繑	xtdk
穎	xtdm
縫	xtdp
欵	xtdw
矤	xtdy
綉	xten
紝	xtfg
纴	xtfg
絎	xtfh
纘	xtfm
綎	xtfp
綞	xtgf
緟	xtgf
纁	xtgo
縰	xthh
綹	xthk
綖	xthp
緮	xtjt
蚃	xtju
絡	xtkg
總	xtln
繌	xtlt
紇	xtnn
繙	xtol
鄕	xtrb
縦	xtuh
終	xtuy
郷	xtvb
緌	xtvg
縱	xtwh
鄉	xtyb
饗	xtye
蠁	xtyj
響	xtyj
嚮	xtyk
絣	xuah
織	xuaj
縌	xubp
縒	xuda
綣	xudb
絴	xudh
繕	xudk
繝	xueg
繸	xuep
彅	xuev
紏	xufh
絆	xufh
繶	xujn
縂	xukn
綐	xukq
繒	xulj
締	xuph
縍	xupy
纐	xuqm
絘	xuqw
絞	xuqy
繜	xusf
緧	xusg
縑	xuvo
縊	xuwl
鶸	xuxo
綈	xuxt
絕	xvcn
縁	xvey
繣	xvfg
紣	xvfh
彇	xvhh
繡	xvhh
緑	xviy
繅	xvjs
弨	xvkg
紹	xvkg
緇	xvlg
糿	xvn
繍	xvoj
綅	xvpc
匘	xvtq
綛	xvyn
紈	xvyy
紉	xvyy
総	xwcn
緞	xwdc
絥	xwdy
紾	xwet
絵	xwfc
縩	xwfi
弣	xwfy
紨	xwfy
綸	xwga
絟	xwgg
緰	xwgj
繪	xwgj
給	xwgk
緶	xwgq
縧	xwhs
紒	xwjh
緥	xwks
緱	xwnd
縋	xwnp
纀	xwoy
絍	xwtf
紛	xwvn
纖	xwwg
緃	xwwh
綌	xwwk
绤	xwwk
紷	xwyc
維	xwyg
紟	xwyn
繈	xxcj
紭	xxcy
幾	xxdt
緣	xxey
坒	xxff
綠	xxgi
斷	xxgr
紖	xxhh
纼	xxhh
顈	xxim
鷥	xxio
絲	xxiy
紼	xxjh
繦	xxkj
弜	xxn
粊	xxou
勓	xxrl
鶛	xxro
纅	xxrs
枈	xxsu
毞	xxtn
紕	xxxn
繼	xxxn
纞	xxyn
彍	xyaw
纊	xyaw
縭	xybc
弴	xybg
綧	xybg
統	xycq
絋	xycy
紸	xygg
弶	xyiy
綡	xyiy
緕	xyjf
纏	xyjf
纒	xyjf
縗	xyke
纕	xyke
缞	xyke
繵	xylg
縞	xymk
紡	xyn
編	xyna
綟	xynd
絯	xynw
綂	xyqn
絒	xyth
縼	xyth
纃	xyvf
綷	xywf
鶭	xywo
孿	xyxb
奱	xyxd
卛	xyxf
繂	xyxf
矕	xyxh
縴	xyxh
灓	xyxi
曫	xyxj
蠻	xyxj
巒	xyxm
戀	xyxn
鸞	xyxo
鑾	xyxq
攣	xyxr
欒	xyxs
變	xyxt
婱	xyxv
孌	xyxv
臠	xyxw
彎	xyxx
絃	xyxy
	xyxy
紋	xyy
弻	xgkx
緖	xfty
龻	xyxi
亹	yvmg
劥	ymlt
勍	yilt
卛	yxxf
夑	yoot
奱	yxxd
孌	yxxv
孿	yxxb
巒	yxxm
庣	yqii
彎	yxxx
戀	yxxn
攣	yxxr
斖	yvmg
旊	yrny
旐	ytqi
旟	ytvw
曫	yxxj
欒	yxxs
灓	yxxi
爕	yooo
犫	ywyh
瓬	ygny
甂	ynmy
甕	yxty
矕	yxxh
臠	yxxw
蠻	yxxj
裵	yhde
訜	ywvt
訪	yyt
詏	yxlt
誂	yqiy
誐	ytry
誘	ytet
誠	ydny
誨	ytxy
誹	yhdd
諈	ytfg
諓	yaay
諴	ydgy
譏	yxxy
議	yugy
變	yxxt
讌	yako
鑾	yxxq
韲	yhdg
鸞	yxxo
麙	ynjy
齏	yjhg
	yako
	yxxy
韲	ydjg
斎	yfij
齏	yjdg
斉	yjf
齊	yjf
齋	yjiu
剤	yjjh
劑	yjjh
齍	yjlf
齎	yjmu
齌	yjou
廔	ylvd
謱	ylvg
麡	ynjj
裦	ywfe
褎	ywfe
褏	ywfe
襃	ywfe
譝	yxg
試	yaag
誡	yaah
諓	yaat
剫	yacj
諾	yadk
諶	yadn
廝	yadr
諆	yadw
讛	yafc
詌	yafg
諽	yafh
謀	yafs
訌	yag
譁	yagf
誆	yagg
衺	yahe
庌	yaht
訝	yaht
庴	yajd
謨	yajd
諎	yajg
譪	yajn
謹	yakg
謳	yakk
讙	yaky
庿	yald
鄺	yamb
懬	yamn
廣	yamw
詎	yang
詍	yann
諜	yans
鷓	yaoo
廗	yaqh
譖	yaqj
讌	yauo
	yauo
護	yawc
庻	yaww
誣	yaww
誮	yawx
謊	yayq
讘	ybbb
諏	ybcy
讔	yben
斈	ybf
斊	ybf
廰	ybfn
誀	ybg
廳	ybgn
詜	ybhc
嚲	ybkf
詘	ybmh
離	ybmy
訑	ybn
墪	ybtf
鐜	ybtq
撉	ybtr
亸	ybuf
廕	ybwc
鶉	ybwo
棄	ycas
譎	ycbk
諁	yccc
謲	ycce
誦	yceh
逳	ycep
裛	yceu
褭	yceu
広	yci
旀	yciy
袬	ycke
詒	yckg
夣	yclq
誒	yctd
誜	ycwt
訍	ycyy
詙	ydcy
詴	ydeg
顏	ydem
彥	yder
誫	ydfe
譇	ydfj
誇	ydfn
詁	ydg
諴	ydgt
緳	ydhi
譿	ydhn
廈	ydht
誄	ydiy
誹	ydjd
裵	ydje
庬	ydne
訧	ydnn
誠	ydnt
詼	ydoy
謜	ydri
旑	ydsk
诪	ydtf
產	ydtg
讈	ydth
彣	yee
諼	yefc
詛	yegg
廫	yene
謡	yerm
譌	yeto
謟	yevg
謑	yexd
訯	yeyy
諑	yeyy
廅	yfcl
詓	yfcy
譳	yfdj
詿	yffg
庤	yffi
謣	yffn
譊	yffq
詩	yffy
計	yfh
訐	yfh
謓	yfhw
廟	yfje
謿	yfje
講	yfjf
廚	yfkf
詰	yfkg
譆	yfkk
讀	yflm
讟	yfly
諵	yfmf
譸	yfnf
誌	yfny
誖	yfpb
読	yfpq
庨	yftb
誟	yftb
詽	yftf
諸	yftj
褻	yfwe
譛	yfwj
廧	yfwk
讃	yfwm
庱	yfwt
対	yfy
討	yfy
庒	yfyi
訮	ygah
贇	ygam
赟	ygam
庉	ygbn
訰	ygbn
庢	ygcf
誈	ygcf
請	ygeg
庯	ygey
誧	ygey
諘	ygey
訏	ygfh
証	yghg
諌	ygji
譓	ygjn
語	ygkg
誎	ygki
讍	ygkk
諨	ygkl
諫	ygli
殶	ygmc
廲	ygmx
謮	ygmy
瓬	ygnn
迬	ygpd
謸	ygqt
評	yguh
誙	ygva
誱	ygvh
讞	yhad
謔	yhag
謯	yhag
譃	yhag
謼	yhah
廬	yhal
諕	yham
詖	yhcy
诐	yhcy
訨	yhg
諔	yhic
詀	yhkg
斍	yhqb
誢	yhqn
訿	yhxn
庛	yhxv
訃	yhy
蹵	yidh
鷲	yido
誚	yieg
氷	yii
誻	yijg
剠	yijh
勍	yiln
廠	yimt
譡	yipl
讜	yipo
誂	yiqn
庣	yiqv
訬	yitt
鶁	yiwo
亯	yjf
鄽	yjfb
裏	yjfe
裏	yjfe
斉	yjff
斎	yjfi
剤	yjfj
髙	yjfk
詚	yjgg
諟	yjgh
諹	yjgr
訷	yjhh
亰	yjiu
亣	yjj
誯	yjjg
螡	yjju
螤	yjjw
謾	yjlc
庽	yjmy
恴	yjnu
謁	yjqn
課	yjsy
謃	yjtg
蚉	yju
斔	yjvw
諿	ykbg
誤	ykgd
廔	ykgv
謱	ykgv
訓	ykh
訲	ykhh
譴	ykhp
讉	ykhp
譂	ykkf
勷	ykkl
諤	ykkn
譟	ykks
讝	ykkt
詋	ykqn
廙	ylaw
畆	ylcy
謂	yleg
畗	ylf
譯	ylff
訵	ylg
譞	ylge
褱	ylie
庘	ylk
庫	ylk
皽	ylkc
亶	ylkg
鹯	ylkg
勯	ylkl
顫	ylkm
氈	ylkn
鸇	ylko
邅	ylkp
稟	ylkt
廤	ylkx
讄	ylll
諰	ylny
謰	ylpy
畝	ylqy
謖	ylwt
畒	ylwy
譨	ymae
邟	ymbh
設	ymcy
諯	ymdj
頏	ymdm
詇	ymdy
調	ymfk
詷	ymgk
譝	ymgv
訕	ymh
廁	ymjk
髜	ymka
鄗	ymkb
毃	ymkc
詗	ymkg
诇	ymkg
髝	ymkl
髚	ymkm
鶮	ymko
槀	ymks
髞	ymks
稾	ymkt
髛	ymkv
歊	ymkw
劥	ymln
廮	ymmv
諣	ymnk
迒	ympv
諷	ymtj
誷	ymun
讗	ymwk
訥	ymwy
訉	ymyy
肈	ynah
啔	ynak
誳	ynbm
譀	ynbt
戻	yndi
顅	ynem
鵳	yneo
訊	ynfh
廜	ynfj
詡	yng
詞	yngk
諝	ynhe
谞	ynhe
訆	ynhh
諱	ynhh
扂	ynhk
応	yni
鄜	ynjb
麛	ynjb
麚	ynjc
麌	ynjd
朚	ynje
麎	ynje
塵	ynjf
麡	ynjf
麆	ynjg
麠	ynjg
麖	ynji
蝱	ynjj
麘	ynjj
麞	ynjj
麏	ynjk
麐	ynjk
麔	ynjk
麢	ynjk
麅	ynjn
廌	ynjo
麃	ynjo
麍	ynjq
麑	ynjq
麜	ynjs
慶	ynjt
麕	ynjt
麙	ynjt
麣	ynjt
麀	ynjx
麤	ynjx
吂	ynkf
啟	ynkt
廦	ynku
臝	ynky
贏	ynky
驘	ynky
鸁	ynky
騗	ynmc
帍	ynmh
甂	ynmn
鶣	ynmo
記	ynn
戺	ynnn
焈	ynno
戹	ynnv
譔	ynnw
誋	ynny
扊	ynoo
巟	ynqb
扅	ynqq
謵	ynrg
杗	ynsu
郂	yntb
晵	yntj
啓	yntk
扄	yntk
衁	yntl
謐	yntl
賌	yntm
頦	yntm
棨	ynts
欬	yntw
忞	ynu
悥	ynu
謘	ynuh
肁	ynvh
謬	ynwe
顧	ynwm
鳸	ynwo
訣	ynwy
訫	yny
扆	ynye
訳	ynyy
譵	yogf
帟	yomh
談	yooy
謎	yopy
変	yotu
鵉	yowo
詸	yoy
亪	yoyu
這	ypd
誼	ypeg
誴	ypfi
亴	ypfv
諠	ypgg
諚	ypgh
谉	ypjh
諢	yplh
廀	ypoc
訦	ypqn
詝	ypsh
詫	ypta
讅	yptl
稁	yptu
詑	ypxn
諙	yqaj
椉	yqas
謋	yqas
詆	yqay
訩	yqbh
讻	yqbh
謅	yqbt
詭	yqdb
誵	yqde
譫	yqdy
裦	yqge
褎	yqge
褏	yqge
襃	yqge
詢	yqjg
訽	yqkg
詺	yqkg
讒	yqky
讂	yqmt
袌	yqne
廯	yqod
諊	yqoy
詾	yqqb
袲	yqqe
廞	yqqw
訤	yqqy
誃	yqqy
謠	yqrm
誑	yqtg
諂	yqvg
諍	yqvh
廇	yqyl
訋	yqyy
庪	yrfc
諻	yrgg
詬	yrgk
訢	yrh
	yrh
謕	yrhm
誅	yriy
庍	yrk
廡	yrlo
譕	yrlo
廆	yrqc
謉	yrqc
褢	yrqe
諀	yrtf
螷	yrtj
蠯	yrtj
袠	yrwe
詄	yrwy
廏	yrxc
廐	yrxq
譤	yryt
訴	yryy
諲	ysfg
謤	ysfi
庮	ysgd
訂	ysh
廂	yshd
譚	ysjh
庁	ysk
訶	yskg
謌	yskk
黀	yssc
塺	yssf
犘	yssh
劘	yssj
黁	yssj
麿	yssk
黂	yssm
爢	ysso
穈	ysst
麼	yssx
諃	yssy
庲	ysww
誺	ysww
訹	ysyy
託	ytan
讬	ytan
斿	ytbg
遊	ytbp
庅	ytci
話	ytdg
譑	ytdk
訞	ytdy
誘	yten
膐	ytew
許	ytfh
誥	ytfk
讚	ytfm
誔	ytfp
詵	ytfq
諈	ytgf
諥	ytgf
廭	ytgm
旊	ytgn
旇	ythc
詐	ythf
詯	ythg
誕	ythp
旓	ytie
旐	ytiq
誗	ytjh
詻	ytkg
謥	ytln
謝	ytmf
斾	ytmh
斻	ytmn
訖	ytnn
為	ytno
旙	ytol
譒	ytol
謻	ytqq
旂	ytrh
誐	ytrt
旚	ytsi
旛	yttl
鷟	ytto
庝	ytui
旞	ytup
諉	ytvg
帰	ytvh
旍	ytwc
旝	ytwj
譗	ytwk
旟	ytww
誨	ytxu
訸	yty
旜	ytyg
誁	yuah
旘	yuaj
識	yuaj
庰	yuak
詳	yudh
龐	yued
譋	yueg
譾	yuen
譢	yuep
謭	yuev
譲	yufe
詊	yufh
斕	yugi
讕	yugi
議	yugt
諳	yujg
譩	yujn
廍	yukb
説	yukq
譄	yulj
謫	yumd
謪	yumk
讁	yump
諩	yuog
譜	yuoj
諦	yuph
謗	yupy
諮	yuqk
讇	yuqv
詨	yuqy
譐	yusf
諺	yute
劆	yuvj
謙	yuvo
謚	yuwl
譭	yvac
廄	yvcc
郒	yvcc
塱	yvcf
剆	yvcj
勆	yvcl
欴	yvcw
詉	yvcy
郎	yveb
郞	yveb
鄘	yveb
鷛	yveo
詪	yvey
旔	yvfp
鄌	yvhb
廋	yvhc
謏	yvhc
鶶	yvho
詔	yvkg
廱	yvky
訅	yvn
誛	yvpc
誽	yvqn
齊	yvuf
齏	yvug
韲	yvug
齋	yvui
劑	yvuj
齍	yvul
齎	yvum
齌	yvuo
鹒	yvwg
賡	yvwm
鶊	yvwo
諛	yvwy
譅	yvyh
認	yvyn
訒	yvyy
訙	yvyy
讱	yvyy
庺	ywcs
訟	ywcy
診	ywet
亹	ywfg
斖	ywfg
焤	ywfo
廃	ywfq
詂	ywfy
論	ywga
讑	ywga
詮	ywgg
廥	ywgj
諭	ywgj
譮	ywgj
詥	ywgk
諡	ywgl
證	ywgu
譣	ywgw
庂	ywi
亱	ywjg
斺	ywjh
庎	ywjk
說	ywkq
詤	ywnq
庩	ywti
鵺	ywto
乻	ywun
旕	ywux
訜	ywvn
鳼	ywvo
鴋	ywvo
鴍	ywvo
讖	ywwg
噟	ywwk
顇	ywwm
應	ywwn
鷹	ywwo
譍	ywwy
雜	ywwy
廢	ywxc
訛	ywxn
詅	ywyc
謢	ywyc
﨎	ywyc
誝	ywyk
謒	ywyk
庈	ywyn
訡	ywyn
諗	ywyn
譙	ywyo
庼	yxdm
廎	yxdm
謴	yxfm
訠	yxhh
玅	yxit
詣	yxjg
鄐	yxlb
詏	yxln
牽	yxph
玈	yxte
譺	yxth
罋	yxtm
甕	yxtn
諧	yxxr
譏	yxxt
孶	yxyb
玆	yxyx
誸	yxyx
謶	yyao
謧	yybc
諄	yybg
譈	yybt
旈	yycq
庡	yyei
堃	yyff
誩	yyg
訁	yygg
註	yygg
諒	yyiy
讓	yyke
譠	yylg
乀	yyll
乁	yyll
廩	yylt
謞	yymk
訪	yyn
斒	yyna
諞	yyna
詠	yyni
謆	yynn
該	yynw
廘	yynx
譹	yype
諪	yyps
詶	yyth
譧	yyuo
斏	yyve
誏	yyve
誶	yywf
詃	yyxy
譶	yyyf
誰	ywyg
鿁	yawy
鿥	yvcq
鿮	yahh
