---config@码表分类=主码-9
---config@码表别名=CJKExt_H
𱍥	augg
𱍥	aukg
𱍦	anuy
𱍨	akfg
𱏪	adwq
𱏷	awaw
𱐤	agaj
𱐬	anln
𱐭	anlb
𱑆	agmd
𱑇	agiq
𱑉	aujm
𱑊	auwb
𱑋	aiwk
𱑌	aadn
𱑍	akkk
𱑕	ajmp
𱑘	abh
𱒏	ankf
𱕭	akfw
𱕴	awwk
𱘄	aqkf
𱘜	akkf
𱘽	afcd
𱚡	awyf
𱚮	ahte
𱜙	anwa
𱜚	awwl
𱜛	anhe
𱜝	annm
𱜟	awny
𱞉	annu
𱞝	agun
𱟟	akka
𱟤	amfy
𱟨	atdy
𱡵	amfy
𱢯	aanj
𱣎	ahas
𱤉	ahti
𱥕	ajdx
𱥙	akkc
𱥚	aldc
𱫓	aqqo
𱫳	awno
𱬯	amox
𱭢	ahtn
𱭣	ahtb
𱭤	ahtn
𱭥	ahtf
𱭦	ahtk
𱭧	ahtc
𱭨	ahto
𱰞	aweh
𱰠	ajde
𱲚	ahnl
𱻛	adwn
𱻜	awvn
𱻟	afsn
𱻡	amng
𱽋	auhj
𱽌	adhy
𱽍	afu
𱽎	amu
𱽏	aqff
𱽐	amff
𱽑	agyu
𱽒	aagn
𱽓	ahtw
𱽔	akqb
𱽕	akvr
𱽖	ajhj
𱽗	ahnr
𱽘	awwg
𱽙	awaj
𱽚	aqiu
𱽛	agog
𱽜	arvy
𱽝	agcu
𱽟	asmb
𱽠	amww
𱽡	amww
𱽢	amgq
𱽣	awxf
𱽤	aur
𱽥	aou
𱽦	apfu
𱽧	anhh
𱽨	adtb
𱽩	arcb
𱽪	alfq
𱽫	aigh
𱽬	aiqc
𱽭	agwh
𱽮	atcf
𱽯	aqwk
𱽰	arnv
𱽱	ayny
𱽲	aylk
𱽳	adwn
𱽴	agmj
𱽵	agil
𱽶	akwk
𱽷	ajcl
𱽸	aqjb
𱽹	atwq
𱽺	awtt
𱽻	aelf
𱽼	aiut
𱽽	aitq
𱽾	axqj
𱽿	abth
𱾀	astd
𱾁	aaou
𱾂	afke
𱾃	ahqi
𱾄	amdl
𱾅	aqtw
𱾆	avwy
𱾇	awxf
𱾈	aijf
𱾉	aufj
𱾊	ayte
𱾋	agcq
𱾋	apyq
𱾌	aeal
𱾍	anna
𱾎	afkg
𱾏	adtd
𱾐	aafl
𱾑	ajhc
𱾒	alff
𱾓	alfi
𱾔	alge
𱾖	awyk
𱾗	atxt
𱾘	aqtn
𱾙	agwh
𱾚	alke
𱾛	admn
𱾜	abuw
𱾝	aswy
𱾞	arvj
𱾟	ajlf
𱾠	aqkp
𱾡	aeer
𱾢	aqgj
𱾤	adfa
𱾥	arth
𱾧	amau
𱾨	ajqp
𱾩	apda
𱾫	aiwf
𱾬	adfc
𱾭	afkf
𱾮	adjn
𱾯	alwc
𱾰	atxr
𱾱	amtt
𱾳	afyf
𱾴	afwf
𱾵	astt
𱾶	amlo
𱾸	aufy
𱾹	abun
𱾺	alpi
𱾻	awyy
𱾼	axgh
𱾽	alff
𱾾	atow
𱾿	aiyh
𱿀	anwu
𱿂	ajmm
𱿃	axil
𱿄	aqtt
𱿅	auqw
𱿆	agcu
𱿆	apyu
𱿇	ahtt
𱿉	ajye
𱿊	atdf
𱿋	alpe
𱿌	axri
𱿍	awyh
𱿱	atgh
𲀎	alpj
𲀧	ahte
𲁖	apmq
𲁟	akgh
𲃴	adnh
𲄑	ankh
𲆎	adqp
𲆑	aabh
𲆗	ansb
𲆙	awsb
𲆢	aldb
𲇔	ahnq
𲇩	aiqq
𲊛	afrc
𲊞	afpc
𲊟	afun
𲊠	afiw
𲊡	afuy
𲊸	adwm
𲊾	adwm
𲌵	awwo
𲍨	akko
𲎀	amdg
𱐑	bmnm
𱑙	bjqn
𱕂	bqrx
𱗘	btaf
𱙵	bmh
𱙷	bmy
𱙸	bmwy
𱙹	bbmh
𱙽	bamw
𱙿	bpey
𱚀	bflg
𱚁	bujn
𱛪	bmit
𱣍	bsu
𱤷	bbqw
𱦄	bmiu
𱫼	bmbo
𱬣	bmbn
𱱆	bmbm
𱲍	bnlf
𱵰	bmfo
𱵳	bmfc
𱷻	bttd
𱻷	bgng
𱻸	brng
𱻺	brnt
𱻻	bwgn
𱻼	buog
𱻽	bbmg
𱻾	bxan
𱽞	btbt
𱾕	btbe
𱾲	btbw
𲆞	bffc
𲉉	bwxn
𲉊	buy
𲉋	bhhy
𲉌	brg
𲉍	bckg
𲉎	bgjg
𲉏	bvfh
𲉑	bdac
𲉓	begh
𲉗	bfas
𲉘	bmjh
𲉜	bffc
𲉝	bwgk
𲉞	bajv
𲉟	blhd
𲉠	byef
𲉢	bskb
𲉣	bget
𲉤	bskp
𲉥	buey
𲉦	bskd
𲎯	bmqa
𱍾	cwyy
𱎔	ckaf
𱐠	cdej
𱐾	cqrt
𱑢	cnb
𱑧	citk
𱑨	cfcd
𱑯	cccy
𱑱	caf
𱑳	cygf
𱑵	cvkf
𱑶	ccey
𱔖	ckfk
𱜞	cfwt
𱜠	cwww
𱝦	ccce
𱝼	cnu
𱞓	cqwn
𱬖	ckuo
𱭄	cepc
𱮩	ccjq
𱳕	cchq
𱳛	cbti
𱳜	cbtk
𱹽	cxiu
𱻣	cccn
𱼑	cexi
𲁦	cyng
𲅋	cpi
𲅎	cpd
𲉈	cuga
𲊹	cydm
𲋳	cxxn
𲋴	crcy
𲋶	cyni
𲋷	cuup
𲋸	cgoc
𲋹	cfoy
𲋺	cdcc
𲋻	cebu
𲋼	cukn
𲋽	cfke
𲋿	cgjf
𲌀	cxtu
𲌁	cadr
𲌂	cccn
𲌃	cugt
𲌄	chy
𲌅	cwyc
𲌆	cdqn
𲌈	cyiy
𲌉	cndg
𲌊	cudk
𲌋	cwgu
𲍍	cfqg
𱍓	drpi
𱍢	dqqs
𱍽	dmjp
𱏼	dgkf
𱐝	dubj
𱐷	dnyl
𱑓	djah
𱑜	dfci
𱑝	dsd
𱑞	dgkh
𱑟	dseg
𱑠	dkth
𱑡	drib
𱓱	dpuv
𱕓	dfet
𱖪	dwwf
𱖸	dfaf
𱗬	dhfu
𱗵	deff
𱘤	dept
𱘬	djeq
𱘭	dnb
𱘮	dyb
𱘰	didu
𱘲	dllr
𱘵	dykf
𱘸	dgvb
𱘺	dwwl
𱘼	dfnv
𱘾	dqot
𱙀	dngm
𱙲	djdv
𱙶	dybf
𱚠	dmjf
𱚧	dnqp
𱜡	dmhn
𱜮	dmhy
𱝔	dwaj
𱝨	djde
𱡗	dfnc
𱡞	djbt
𱡯	dajr
𱡰	drth
𱢺	deoy
𱣦	dmhi
𱤽	dhd
𱪬	dou
𱪽	dnfo
𱫀	doff
𱫢	dgkt
𱭿	depd
𱰅	dgdy
𱰐	djdy
𱰢	dkme
𱲋	dlf
𱳨	dun
𱳩	dghn
𱳪	ddy
𱳫	dfvb
𱳭	dfjj
𱳮	deg
𱳯	dwxn
𱳰	drh
𱳱	dtay
𱳳	dqng
𱳴	dgmw
𱳵	dkfh
𱳶	dynf
𱳷	dnug
𱳸	dnwf
𱳹	divg
𱳺	dvpn
𱳼	dvsy
𱳽	dyfh
𱳾	dvfy
𱳿	dnag
𱴀	dnfy
𱴁	dgik
𱴂	dgki
𱴃	drcn
𱴄	dgoy
𱴆	dliy
𱴇	dktf
𱴈	dran
𱴉	dyig
𱴊	dvqb
𱴋	dvyn
𱴌	dfqq
𱴌	dssu
𱴍	ddyp
𱴎	ddtd
𱴏	dlgy
𱴐	dhwb
𱴑	dpqs
𱴒	dqky
𱴓	dwwa
𱴔	difc
𱴕	dpkg
𱴖	dyxq
𱴗	dyhk
𱴘	dawn
𱴙	dgkh
𱴚	dleg
𱴜	drgg
𱴞	dwnd
𱴟	dovg
𱴠	dugj
𱴡	dyut
𱴢	dovn
𱴣	dpgx
𱴤	dfhl
𱴥	dfpi
𱴦	ddkk
𱴨	dldn
𱴩	dlfc
𱴪	djpv
𱴬	dbbj
𱴭	dffn
𱴮	daey
𱴮	dgje
𱴯	dwvs
𱴰	dyao
𱴱	dfln
𱴳	dada
𱴴	dqtj
𱴵	dvfg
𱴶	dbtg
𱴷	dldd
𱴸	djfe
𱴹	dfcc
𱴺	djxs
𱴻	dqkq
𱴼	dooh
𱴽	dype
𱴾	dpdv
𱴿	dlcc
𱵁	dptl
𱵂	dfkh
𱵃	ddtj
𱵄	dhhc
𱵅	dnfj
𱶇	dtdt
𱻰	dmjf
𱻲	divg
𱻳	digk
𱻴	digm
𱻵	dilg
𱻿	dcvh
𱿏	dchq
𱿑	dmjq
𲁔	ddnq
𲄊	djeh
𲅊	dfet
𲅓	dmhp
𲅵	djpp
𲈦	dnuj
𲉨	dnwy
𲉮	dmwy
𲊙	dthf
𲊜	dafj
𲊪	dmgh
𲊭	dmqb
𲋃	dgkm
𲋎	dcmq
𲋒	djdu
𲋛	dhwe
𲋛	dmwe
𲌇	dskc
𲌚	dekf
𲌛	dewf
𲌜	defu
𲌝	dekj
𲌞	deus
𲌟	dewy
𲌠	dewn
𲌡	defk
𲌢	deaf
𲌣	dejp
𲍳	deqg
𲎁	dfeg
𱍹	eyi
𱏹	ehk
𱐛	evjh
𱐮	eln
𱑐	ewfp
𱑲	egcu
𱘪	ehqq
𱙺	ebwx
𱚢	ecmf
𱜲	egbh
𱝣	eeet
𱞍	enu
𱡟	efct
𱢹	effg
𱢻	ewgn
𱢼	eahl
𱥈	eehc
𱫃	egno
𱬵	eqnb
𱬷	ecb
𱬹	ehjf
𱬻	easu
𱬼	egtu
𱬾	ehfy
𱭂	ephj
𱭃	eprt
𱭇	elhf
𱭉	epdj
𱯭	emxy
𱰙	eetg
𱰜	env
𱰝	egkq
𱲐	efwl
𱲑	eglf
𱳁	efth
𱼁	een
𱼂	eghy
𱼅	egkq
𱼆	efbn
𱼇	ewxf
𱼈	etjg
𱼉	emy
𱼋	eyve
𱼌	eipm
𱼍	eseg
𱼎	ejog
𱼏	ekhm
𱼐	ewvl
𱼒	evgf
𱼓	etfh
𱼔	edat
𱼕	edha
𱼖	exdm
𱼗	eonr
𱼙	eyng
𱼜	evku
𱼝	eaga
𱼞	edgn
𱼡	epwk
𱼢	ealt
𱼣	etxe
𱼤	eyxf
𲁝	evqf
𲂡	egnk
𲂤	eemf
𲂥	eetb
𲂦	eebl
𲂧	eell
𲅜	eapd
𲅻	edmp
𲆋	ecmp
𲆣	efhb
𲊖	evhg
𲋵	egcu
𲌥	elqf
𱍐	fiu
𱍑	fcgf
𱎓	fqqt
𱎕	ffwy
𱎠	fjwi
𱏎	fpbj
𱐘	fwwj
𱐱	fhnl
𱐵	fall
𱑣	fcuh
𱑤	fchg
𱑦	fcjx
𱑩	fckw
𱑪	fcyf
𱑫	fcpk
𱑬	fctq
𱑭	fcvf
𱑰	fcfk
𱔳	fkuv
𱕞	fnmk
𱕡	fjgk
𱖇	ffh
𱖈	fgqn
𱖊	fitt
𱖍	fwcy
𱖎	ftdy
𱖏	fwbn
𱖑	fang
𱖒	fdxy
𱖕	fkwy
𱖖	fhgg
𱖘	fthy
𱖙	fwmh
𱖛	fwhg
𱖜	fcfg
𱖝	fgmf
𱖞	fdhf
𱖟	fagg
𱖠	ftxf
𱖡	fdfy
𱖢	fitl
𱖤	fwtf
𱖥	fqcn
𱖧	fukh
𱖨	fyey
𱖩	flpn
𱖫	faww
𱖬	fgoy
𱖭	famy
𱖮	flsy
𱖯	flqm
𱖰	fevg
𱖱	fqdh
𱖲	fujg
𱖳	fpqa
𱖴	fpeg
𱖶	fifg
𱖷	fnfc
𱖹	fsww
𱖺	flgy
𱖼	fmty
𱖽	fkhn
𱖾	fdjd
𱗀	frgm
𱗂	fwfk
𱗃	fqaj
𱗅	fqde
𱗆	fwgq
𱗇	fiff
𱗉	fuey
𱗊	fbsk
𱗋	fafh
𱗌	fgkj
𱗍	fgif
𱗎	fmxx
𱗏	fjtq
𱗑	fjtf
𱗒	fhag
𱗔	fqvn
𱗖	fukn
𱗗	fyud
𱗙	fnhc
𱗚	fcel
𱗛	fddy
𱗜	fdfk
𱗝	fbcc
𱗞	fmeg
𱗟	flwb
𱗠	fhan
𱗡	fhay
𱗢	fjiq
𱗤	frdf
𱗥	fqye
𱗦	fere
𱗨	fyon
𱗩	fvep
𱗪	fwhf
𱗫	fffn
𱗭	fogk
𱗮	fham
𱗯	fwtf
𱗰	ftmq
𱗱	fmfe
𱗲	fthk
𱗴	fgif
𱗶	ffwj
𱗸	fjbc
𱗹	funy
𱗺	fhxi
𱗻	flfo
𱗽	fwyp
𱗿	fpjh
𱘀	fyct
𱘃	fxjm
𱘅	fkhk
𱘆	fqeh
𱘇	frfp
𱘉	fyto
𱘊	fovt
𱘋	fdqq
𱘍	fdje
𱘎	fqve
𱘏	fpxm
𱘐	fudy
𱘑	fpwi
𱘒	fnup
𱘓	fjfo
𱘔	fboh
𱘕	fgjh
𱘗	ftun
𱘘	fugi
𱘛	foyo
𱘝	fiay
𱘞	fxys
𱘟	ffkw
𱘠	fnyf
𱘡	fpgg
𱘢	fnpi
𱘹	fjdh
𱙼	fwwb
𱙾	ftbn
𱛈	fcmj
𱜽	fklj
𱜾	fyey
𱜿	fuft
𱝁	fuff
𱝎	fcyo
𱝐	fclo
𱝢	fqfe
𱟝	fada
𱡚	fpxt
𱡛	fqft
𱢑	fjff
𱣀	fcsu
𱤜	fiwj
𱤧	ffti
𱥖	fmmc
𱥗	fpbc
𱥛	fixu
𱧲	ffii
𱪿	fclo
𱫠	fmuo
𱫱	fkgo
𱫿	fojo
𱬁	fqfo
𱬝	ftji
𱬨	fpgo
𱯀	fckg
𱯏	fmgy
𱰎	fnmy
𱰦	fcjh
𱱁	fwwl
𱲆	fdtc
𱲎	felf
𱲓	fotl
𱲘	fhfl
𱲸	fich
𱲿	fhgh
𱳊	fkuh
𱴧	fpdc
𱵆	fitk
𱵇	fiyv
𱵈	fikq
𱵉	fitw
𱵌	ficd
𱵍	fify
𱵎	fifh
𱵏	fijf
𱵐	fiji
𱵑	fith
𱵒	fiye
𱵓	fiyq
𱵔	fink
𱵕	fidj
𱵖	fihh
𱵘	firu
𱵚	fivf
𱵛	finf
𱵝	fiey
𱵞	fity
𱵟	fiod
𱵠	fiif
𱵡	fidt
𱵢	figk
𱵣	fikk
𱵤	filk
𱵦	fiql
𱵧	fiff
𱵨	fiuj
𱵩	fiuy
𱵪	fink
𱵬	fiow
𱵭	fibf
𱵱	fivu
𱵲	fiww
𱵴	fidu
𱵵	fifk
𱵶	fiog
𱵷	fivu
𱶡	fjtq
𱶢	fumt
𱹣	fnko
𱻞	famn
𱻦	fshn
𱻨	ftxm
𱻩	ftxg
𱻪	ftxc
𱻫	ftkn
𱻬	ftnn
𱻭	ftfy
𱻮	ftvk
𱻯	ftjj
𱻹	fkbf
𱼚	fidw
𱼲	fbfa
𱾡	ffer
𱿔	fufq
𱿛	fqju
𲁕	fkmq
𲂞	fkuk
𲂟	fpgk
𲂠	fkui
𲃇	fovq
𲃈	foal
𲃉	fhcd
𲃉	fhcg
𲃊	fhry
𲃋	fhnx
𲃌	fhkq
𲃍	fhev
𲃎	fhtj
𲃏	fhgm
𲃐	fhnx
𲃑	fhak
𲃒	fhgw
𲃓	fhyt
𲃼	ftjh
𲄆	ftjh
𲅐	fnyp
𲅟	ftrp
𲆈	fnhp
𲆒	fybh
𲆟	fofb
𲈢	fwwc
𲉰	feb
𲉲	fyfj
𲉳	fgou
𲉴	fntr
𲉵	frvy
𲉶	fwdu
𲉷	fwat
𲉸	fkuf
𲉹	ffnx
𲉺	faau
𲉻	fbbj
𲉼	fjsu
𲉽	fqty
𲉾	ftyg
𲉿	fiaf
𲊀	fpeg
𲊁	fvhf
𲊂	ffao
𲊂	ffoa
𲊃	fwvy
𲊄	fqnk
𲊅	fwhs
𲊆	fyyb
𲊇	fyss
𲊈	fijh
𲊉	fiih
𲊊	fwgn
𲊋	ffup
𲊌	fwgy
𲊍	fjad
𲊎	fkkw
𲊏	fiaj
𲊐	figj
𲊑	ffcf
𲊒	fyjc
𲊓	ffch
𲊔	fnwt
𲊔	fnwy
𲊥	fnhg
𲊳	fkum
𲊴	ftjm
𲊼	fodm
𲋂	fwfm
𲌤	fupc
𲌦	funf
𲌶	fqot
𲍉	fqqg
𲎏	fwwc
𲎗	fhwo
𲎛	fkua
𲎜	fkus
𲎣	fwtb
𲎤	fqfb
𱍔	ghdx
𱍕	giww
𱍗	giuc
𱍚	giqq
𱍛	giwk
𱍟	gngn
𱍡	giuh
𱍤	gijh
𱍪	gmyc
𱎁	ginv
𱎁	gtyn
𱎑	gkvc
𱎒	gmff
𱎖	gfmf
𱏤	giiq
𱐒	ghnj
𱐽	gmag
𱒑	gmwk
𱒕	gikc
𱒭	gosk
𱒮	gsck
𱒷	gkxb
𱖅	gilm
𱖓	gyff
𱘱	gady
𱘴	guwc
𱘶	gdnr
𱘷	gdwj
𱙎	gogv
𱙳	gvhy
𱙻	gobg
𱚯	gqeq
𱛄	gbnb
𱜹	gjap
𱝓	gigp
𱝖	gaua
𱝥	gkip
𱞂	gnu
𱟅	gchn
𱡘	goty
𱡙	gogc
𱣟	gvii
𱤑	golp
𱤒	gsad
𱤦	gkhs
𱤻	ghhg
𱤻	gjgd
𱥂	ghgh
𱥋	gqmy
𱥎	gqxk
𱥏	gqhj
𱥐	gqwb
𱥑	gqmk
𱥒	gqde
𱥓	gqnh
𱥔	gqaa
𱥝	gxft
𱥠	guwn
𱥽	ghfi
𱩤	ghim
𱪥	ghou
𱪲	ghou
𱫆	ghno
𱫇	gifo
𱫒	gdfo
𱫡	gcvo
𱭆	ginf
𱭌	gmiv
𱮡	gvtq
𱮪	gvty
𱮫	gvtq
𱮳	gjg
𱮴	gmqy
𱮵	gnny
𱮶	gvhh
𱮷	gfiy
𱮸	gkqn
𱮹	gwgw
𱮺	ghmy
𱮽	gcrh
𱮾	ggoy
𱮿	gdtb
𱯂	gtoh
𱯃	gyqg
𱯄	gpgy
𱯅	gycw
𱯆	gcde
𱯇	gccc
𱯈	gvfm
𱯉	gyce
𱯊	gghh
𱯋	gleg
𱯌	gelg
𱯍	gskk
𱯎	ggke
𱯐	ggki
𱯒	glgn
𱯓	ghgn
𱯔	gjgi
𱯕	glfm
𱯖	gqdb
𱯗	gqqb
𱯘	gyxa
𱯙	gpuh
𱯚	gujn
𱯛	gvji
𱯜	gfuk
𱯝	ggmy
𱯞	ggmj
𱯟	ghls
𱯠	gxxa
𱯠	gxxy
𱯡	gyxn
𱯡	gyxy
𱯣	gdxy
𱯤	gqkp
𱯥	gugw
𱯦	grns
𱯧	gpgl
𱯨	gght
𱯩	gflg
𱯪	gvfc
𱯫	gtlt
𱯬	gtmd
𱯮	goof
𱯯	gfle
𱯰	gpxw
𱯱	gypm
𱯲	gxgs
𱯴	gilr
𱯵	gdnc
𱯶	gyhw
𱯷	gqlt
𱯷	gqly
𱯸	gwmm
𱯹	gwtt
𱯺	gpqw
𱯼	gahm
𱯽	gtrb
𱯾	gqlq
𱯿	gqjt
𱰀	gfwq
𱰀	ggpq
𱰁	gwfb
𱰂	gyqq
𱰃	gyqd
𱰑	gnnc
𱰒	gnny
𱰟	gaeh
𱰥	glgf
𱰸	gile
𱰺	goll
𱲶	gphn
𱵙	gpen
𱵥	gpjl
𱶟	gngt
𱷣	giuf
𱹅	gsou
𱺋	ghoi
𱼩	gcdh
𱼪	gcfl
𱼬	gcft
𱽇	gcve
𱿴	gkij
𲀰	gqfe
𲁃	gkhe
𲁑	gimq
𲁜	gjqf
𲂝	gkuf
𲃗	gikh
𲄳	gjfd
𲄵	gjff
𲄶	gjfj
𲄷	gjfh
𲄸	gjff
𲄹	gjfg
𲄼	gjfc
𲄽	gjfd
𲄾	gjfi
𲅚	glpk
𲅴	giwp
𲆁	gbnp
𲆐	gmwb
𲆮	gsgn
𲉱	gphe
𲉱	gpie
𲊕	getn
𲊗	gmhe
𲊘	gejl
𲊺	ghdm
𲋗	gqje
𲍛	gbno
𲍞	gmho
𲍣	gogo
𲍭	gbng
𲎐	gwwt
𲎑	gtlp
𲎒	gtyy
𲎓	gtft
𲎚	gafc
𱍩	hfdj
𱎷	hxww
𱏶	hwdg
𱐞	hvhv
𱑖	hphn
𱖻	hjwf
𱚟	hcfy
𱜦	hguh
𱜧	hxgh
𱜶	hxuh
𱟞	hdht
𱡫	hnrh
𱡮	hmnr
𱡹	hjhh
𱤊	hpvs
𱤼	hsh
𱤾	htnn
𱥀	hqcy
𱥁	hvkg
𱥃	hqwe
𱥄	hyps
𱥉	hxun
𱥌	hmyc
𱥍	hqgn
𱭈	heec
𱮻	hqgf
𱰔	hhwy
𱰕	hagy
𱱹	hwgu
𱱿	hchy
𱲀	hcuh
𱲁	hcmd
𱲂	hcvh
𱲃	hcmw
𱲄	hciq
𱲅	hcjn
𱲇	hcas
𱲉	hcbb
𱲊	hchm
𱲞	hndl
𱲥	hnrt
𱲦	hfqn
𱲩	hiwu
𱲪	huy
𱲫	hcn
𱲭	hufh
𱲮	hcfh
𱲰	hvcy
𱲱	hidu
𱲲	hpwh
𱲳	hwoy
𱲴	haqn
𱲵	hgwf
𱲷	hrat
𱲹	hkhy
𱲺	hwsg
𱲽	hswc
𱲾	hgvv
𱳀	hqrm
𱳂	htgh
𱳃	hdhd
𱳄	hrdf
𱳅	hbcc
𱳇	hwtf
𱳉	hfuy
𱳋	hssh
𱳌	hhpk
𱳍	hkhk
𱳎	hqqy
𱳏	hquk
𱳐	hqdk
𱳑	hqak
𱳒	hyyb
𱳔	hnky
𱳖	hqnk
𱳗	hptl
𱳘	hahq
𱳙	hqdk
𱳚	hyad
𱴅	hdck
𱵜	hgdi
𱼦	hagw
𱿎	haql
𱿐	hamy
𱿓	hatn
𱿖	hagq
𱿗	haqq
𲁐	hqtm
𲂚	haok
𲂣	haet
𲂨	hwwx
𲂸	hwfa
𲄋	hfth
𲄴	hngf
𲄴	hnlh
𲅖	hcpi
𲅗	hmpi
𲅮	hpup
𲅶	hfup
𲇖	hhqf
𲉒	hnnt
𲉕	hnnh
𲉖	hnnw
𲉚	hnns
𲉛	hnnt
𲉡	hnnh
𲊰	haqm
𲍵	hxqg
𲎊	hlqj
𲎢	hwwk
𲎥	haeb
𲎧	hwbc
𲎨	hwbk
𲎩	hwbt
𲎪	hwbc
𲎫	hwbm
𱍙	imks
𱎎	ialn
𱏦	iqug
𱏩	iqwf
𱏮	iqge
𱏮	iqye
𱏰	iqfl
𱏵	imgw
𱑸	imkc
𱑾	ipic
𱔛	iqik
𱗧	iahf
𱘈	ipdf
𱘙	iudf
𱙘	icvf
𱚣	itqg
𱚤	ibmj
𱚥	iuft
𱚦	idlf
𱚦	idmd
𱚨	idph
𱚩	ifti
𱚪	itty
𱚫	itty
𱚬	idqq
𱠤	inra
𱥰	iuhh
𱥱	int
𱥲	idmn
𱥳	ifjh
𱥴	igfy
𱥵	imqy
𱥶	ihbh
𱥸	iwhy
𱥹	imfg
𱥺	iucy
𱥻	ivwy
𱥼	igyy
𱥾	igng
𱥿	ihhg
𱦀	ikln
𱦁	iwfg
𱦂	ihgb
𱦃	ixht
𱦅	ifcl
𱦇	idyn
𱦈	ilvn
𱦉	idhg
𱦊	irvy
𱦋	ilkf
𱦌	ihdy
𱦍	iknw
𱦎	ihqq
𱦏	iwww
𱦐	iwfb
𱦑	iwfy
𱦒	iesh
𱦓	iebh
𱦔	ityi
𱦔	iwiy
𱦖	itfm
𱦗	itdy
𱦘	icdq
𱦙	idns
𱦚	ideg
𱦛	ifgy
𱦜	ilfq
𱦝	ikkh
𱦞	ihjc
𱦟	ithw
𱦠	ikwq
𱦡	iayn
𱦢	iqwv
𱦣	iwqk
𱦤	iqth
𱦥	irin
𱦦	iqg
𱦧	iwhc
𱦨	iqeh
𱦩	iyey
𱦪	iuty
𱦫	ioiy
𱦬	iphg
𱦭	iuga
𱦮	infp
𱦯	ivty
𱦰	iafw
𱦱	iduv
𱦲	isty
𱦳	ilty
𱦴	ipqi
𱦵	ihwy
𱦶	ilfn
𱦷	irqw
𱦸	iriy
𱦹	iqfi
𱦺	iqth
𱦻	iwwg
𱦼	iynh
𱦽	ipxc
𱦾	irno
𱦿	ipbl
𱧀	iywf
𱧁	ivfi
𱧂	infs
𱧃	ivsg
𱧄	idnn
𱧅	imwn
𱧆	iiqw
𱧈	igmf
𱧉	ifpl
𱧊	idji
𱧋	ianj
𱧌	igai
𱧍	idha
𱧎	idcc
𱧏	iafa
𱧐	ipqi
𱧑	ipqo
𱧒	iaeh
𱧓	ildh
𱧔	iawc
𱧕	iwff
𱧖	iqno
𱧗	iwtj
𱧘	iqts
𱧙	iwwu
𱧚	iqqw
𱧛	iudb
𱧜	iujy
𱧝	ioxn
𱧞	ignj
𱧟	ipqc
𱧠	iptk
𱧡	ipoy
𱧢	iuqv
𱧣	iync
𱧤	iutl
𱧥	iumk
𱧦	iody
𱧧	iyvb
𱧨	ivtm
𱧩	inny
𱧪	ivpo
𱧫	icqf
𱧬	ivvm
𱧭	ibve
𱧮	ifjf
𱧯	idhr
𱧰	ifui
𱧱	igqi
𱧳	irde
𱧴	ihlg
𱧵	iaqj
𱧶	imct
𱧷	iaqc
𱧸	iitf
𱧹	ikhl
𱧺	iogn
𱧻	iakd
𱧼	iamu
𱧽	iogi
𱧾	iuxg
𱧿	iphg
𱨀	ikvs
𱨁	iliy
𱨂	ijxi
𱨃	ihej
𱨄	iiwe
𱨅	iwwb
𱨆	iyji
𱨇	iyne
𱨈	ifib
𱨉	iume
𱨊	ignm
𱨋	isdj
𱨌	igkv
𱨍	idtt
𱨎	igpw
𱨏	idfe
𱨐	idgw
𱨑	ilud
𱨒	ilie
𱨓	iajd
𱨔	ilff
𱨕	iwho
𱨖	iqlo
𱨗	iqbl
𱨘	iqpe
𱨙	ittf
𱨚	iugl
𱨛	iykb
𱨜	iyon
𱨝	iyat
𱨞	iwgl
𱨟	iyth
𱨠	iywe
𱨡	iynh
𱨢	iclf
𱨣	iwvq
𱨤	icii
𱨥	icwd
𱨦	idcy
𱨧	idsw
𱨨	igpw
𱨩	ianl
𱨪	ighg
𱨫	isfo
𱨬	iimt
𱨭	ikfd
𱨮	ijlf
𱨯	imaj
𱨰	ildd
𱨱	ijqc
𱨲	ijff
𱨳	iqyj
𱨴	iqtg
𱨵	iqwk
𱨶	iwhi
𱨷	iutg
𱨸	iuid
𱨹	iwfd
𱨺	ipdm
𱨻	iuwy
𱨼	iyuy
𱨽	ipfw
𱨾	ipnq
𱨿	iuuj
𱩀	ivfe
𱩁	ixtu
𱩂	ixtm
𱩃	isho
𱩄	issh
𱩅	ifsf
𱩆	ixgh
𱩇	igxy
𱩈	idhi
𱩉	iftl
𱩊	igen
𱩋	irem
𱩌	idyf
𱩍	ikki
𱩎	ilud
𱩏	ijdo
𱩐	iufi
𱩑	iakj
𱩒	ilqe
𱩓	iuqv
𱩔	ijtq
𱩕	ihwh
𱩖	iqyx
𱩗	ibqt
𱩘	itfk
𱩙	iyvi
𱩚	iyfh
𱩛	iwfi
𱩜	iybj
𱩝	iubj
𱩞	iith
𱩟	impe
𱩠	ifcc
𱩡	ifjn
𱩢	ihdh
𱩣	igoo
𱩥	ijxy
𱩦	ihdh
𱩧	ijan
𱩨	ihtw
𱩩	iakd
𱩪	iajl
𱩬	iync
𱩭	iuko
𱩮	iync
𱩯	iymc
𱩰	ifpm
𱩱	iffi
𱩲	igmc
𱩳	ihah
𱩴	iogy
𱩵	ikft
𱩶	iuuq
𱩷	iqdk
𱩸	itle
𱩹	itmj
𱩺	itdt
𱩻	ideg
𱩼	ifkd
𱩽	igkk
𱩾	ijao
𱩿	iuxw
𱪀	ijbh
𱪁	iadi
𱪂	iqdk
𱪂	iqdy
𱪃	iqnk
𱪄	iync
𱪅	iyny
𱪆	ixyx
𱪇	iyct
𱪈	iswj
𱪉	iynm
𱪊	iynm
𱪋	iynn
𱪌	iolo
𱪍	iyxs
𱪎	ipfm
𱪏	iayh
𱪐	ihpt
𱪑	iaqk
𱪒	iqdk
𱪓	iayl
𱪔	ijjx
𱪕	iyki
𱪖	ifjn
𱪗	ifjn
𱪘	ihhc
𱪙	iyny
𱪚	itfk
𱪛	iygy
𱪜	iyny
𱪝	iujm
𱪞	iygy
𱪟	iygy
𱪠	iyny
𱪺	iwuu
𱫂	ivou
𱫸	iyvo
𱬄	iajo
𱮤	ilgq
𱮼	iqyg
𱰲	ipgl
𱰷	iilf
𱱅	irag
𱲈	iqfc
𱲒	inrl
𱵮	ighi
𱶿	ipqt
𱿮	ihcj
𲃕	ikhu
𲄝	ivtt
𲅌	ipi
𲆯	ipqg
𲋓	iqfu
𲍸	ieqg
𲍼	itdg
𲎄	igeg
𲎅	igkg
𱍬	jnwy
𱍭	jvey
𱍮	jycq
𱍯	jmgk
𱍰	jgog
𱍱	jmum
𱍲	jrmh
𱍳	jajg
𱍴	jugv
𱍵	juvo
𱍶	jyno
𱏏	jfwt
𱏭	jgqq
𱑏	jfhh
𱖣	jjcf
𱖿	jcfh
𱗐	jfwf
𱗓	jcfi
𱗷	jjjf
𱘌	jcfw
𱘫	jffq
𱛅	jmh
𱟛	jxyn
𱠋	jxxt
𱡝	jwgt
𱡺	jfcy
𱡻	jwgn
𱡼	jyly
𱡽	jygg
𱡾	jann
𱡿	jdjg
𱢀	jgne
𱢁	jmqy
𱢂	judh
𱢃	jqto
𱢄	jrgw
𱢅	jqrn
𱢆	jwtu
𱢇	jxhh
𱢈	jctd
𱢉	jgeu
𱢊	jahh
𱢋	jtbf
𱢌	jwgn
𱢍	jpnn
𱢎	jpuv
𱢏	jdgt
𱢐	jfth
𱢒	jfje
𱢓	jrpf
𱢔	jlny
𱢕	jjhg
𱢖	jwvl
𱢗	jnuu
𱢘	jqvn
𱢙	jbcc
𱢚	juwi
𱢛	jtgx
𱢜	jpgk
𱢝	jywj
𱢞	jgve
𱢟	jytj
𱢠	jbwt
𱢡	jgqg
𱢢	janf
𱢣	jjfh
𱢤	juft
𱢥	jffh
𱢦	jgmi
𱢧	jdwp
𱢨	jmgt
𱢩	jtwk
𱢪	jwys
𱢫	jwym
𱢭	jgqw
𱢮	jhae
𱢰	jmlo
𱢱	jhan
𱢲	jqmq
𱢴	jwgw
𱢶	jlck
𱤸	jmhw
𱫕	jnfo
𱫥	jqno
𱮲	jyxy
𱰰	jgwf
𱲔	jfdl
𱵗	jefi
𱵸	jpfd
𱹖	jawo
𱻉	judh
𱼫	jpgf
𱿘	jngg
𱿙	jnuy
𱿚	jdlt
𱿜	jny
𱿝	jttc
𱿞	jufg
𱿟	jdmj
𱿠	jaqy
𱿡	jmqy
𱿢	jany
𱿣	jdqn
𱿤	jktk
𱿧	jujg
𱿩	jfjp
𱿪	jfvk
𱿫	jimk
𱿬	jamf
𱿭	jteg
𱿯	jgih
𱿰	jrwk
𱿲	jafh
𱿳	jdjb
𱿵	jaqk
𱿶	jwvl
𱿷	jrgh
𱿸	jytb
𱿹	jptq
𱿺	jujg
𱿼	jfjf
𱿽	jlgh
𱿿	jwqq
𲀀	jydj
𲀁	jdha
𲀂	jfuk
𲀃	jmee
𲀄	jhag
𲀅	jehv
𲀆	jytd
𲀈	jafm
𲀉	jadt
𲀊	jgqw
𲀍	jjyj
𲀐	jnny
𲀒	jgmv
𲀓	jelf
𲀕	joyo
𲀖	jagt
𲂫	jvmy
𲃀	jvmy
𲅠	jqbp
𲅧	jogp
𲆚	jfhb
𲇂	jfxf
𲇃	jgjl
𲇍	jmcq
𲈴	jfhu
𲊫	jhdm
𲊱	jhdm
𲊵	jpvm
𲊷	jkhm
𲊿	jogm
𲋭	jghh
𲍪	jmho
𲍽	jjqg
𲎕	jamw
𱍠	kkkh
𱍿	kfky
𱐎	kmwb
𱑗	kmhy
𱑿	knnn
𱒀	kdnn
𱒁	kfnn
𱒂	knrt
𱒃	kiu
𱒄	knn
𱒅	kbhk
𱒆	kgdy
𱒇	khbh
𱒈	kjg
𱒉	kmnn
𱒊	kwfg
𱒌	kqbh
𱒎	kccy
𱒐	kdnt
𱒒	khf
𱒓	kish
𱒔	kdfy
𱒖	kshy
𱒗	kamy
𱒘	kgsh
𱒙	kdfh
𱒚	kgkq
𱒛	kkyn
𱒜	kidy
𱒝	ktln
𱒞	kqsy
𱒟	kwqb
𱒠	keln
𱒡	kumh
𱒣	kyln
𱒤	kvqy
𱒥	kvkg
𱒦	kdtf
𱒧	krbc
𱒨	katd
𱒩	kset
𱒪	kdah
𱒫	krnw
𱒬	krwu
𱒯	khln
𱒰	kafy
𱒲	kwln
𱒳	kqtg
𱒴	kwdg
𱒵	ktmc
𱒶	kuny
𱒸	kuat
𱒹	kiey
𱒺	kihg
𱒻	kxty
𱒼	kelg
𱒽	ksgi
𱒾	ksoy
𱒿	ksqa
𱓀	kdlg
𱓁	kalw
𱓂	kkks
𱓄	kamf
𱓅	ktfx
𱓆	krpg
𱓇	ketn
𱓈	ketf
𱓉	kqdj
𱓊	kwff
𱓋	kwaw
𱓌	krwp
𱓍	kqae
𱓏	kpuv
𱓐	kpud
𱓒	kyvw
𱓓	knpy
𱓔	kxfm
𱓕	kvcx
𱓖	ksgh
𱓗	kdmf
𱓘	kdcc
𱓙	krff
𱓚	kkkc
𱓛	kjog
𱓜	katu
𱓝	kkdm
𱓞	kwyg
𱓟	keuf
𱓠	kwkh
𱓡	krhb
𱓢	ketg
𱓣	kudb
𱓤	kyuq
𱓥	kuud
𱓦	kiwk
𱓧	kudj
𱓨	kbbb
𱓩	kwgd
𱓪	kgng
𱓫	ksud
𱓬	kdep
𱓭	ksdn
𱓮	kdth
𱓯	ksyw
𱓰	krvo
𱓲	kaps
𱓳	klgh
𱓴	kaaw
𱓵	kqbh
𱓶	kwtn
𱓷	ktnt
𱓸	kqsh
𱓹	kwjs
𱓺	kwdk
𱓻	kwnh
𱓼	kqfh
𱓽	kyon
𱓾	kugi
𱓿	kifb
𱔀	kytj
𱔁	kntu
𱔂	kywj
𱔃	kvut
𱔄	krwk
𱔅	krdn
𱔆	kkpk
𱔇	kjgy
𱔈	kkga
𱔉	khjp
𱔊	kjcm
𱔌	ktdx
𱔍	krqq
𱔎	kwle
𱔏	ktvq
𱔑	kice
𱔒	kymc
𱔓	kpdk
𱔔	kxfm
𱔕	kxil
𱔗	kgqe
𱔘	ksxi
𱔙	kfiu
𱔚	kaqo
𱔜	kkkb
𱔝	kjwk
𱔞	kkfe
𱔟	kewl
𱔠	kqje
𱔡	ktfh
𱔢	kqtj
𱔣	kpdj
𱔤	kpqh
𱔥	kwsd
𱔦	kimj
𱔧	kytf
𱔨	kyve
𱔩	kuja
𱔪	kywy
𱔫	kpqk
𱔬	kijl
𱔭	kyoj
𱔮	kuge
𱔯	knbb
𱔰	kchq
𱔱	kblh
𱔲	kxwk
𱔴	kfwb
𱔵	kshn
𱔶	ksgg
𱔷	keyd
𱔸	krll
𱔹	ksov
𱔺	kfxj
𱔻	kaqt
𱔼	khyo
𱔽	khch
𱔾	khtf
𱔿	kqej
𱕀	kpqs
𱕁	kied
𱕃	knhp
𱕄	kvjj
𱕅	kdsj
𱕆	ksgk
𱕇	ksui
𱕈	kajf
𱕉	kjse
𱕊	kkhp
𱕋	ktha
𱕌	ktlq
𱕍	ktaw
𱕐	kpne
𱕑	kujk
𱕒	kytu
𱕔	kaan
𱕕	krwc
𱕖	ksdv
𱕗	kfwh
𱕗	kfwl
𱕘	kito
𱕙	kkhi
𱕚	kwww
𱕛	kisj
𱕜	kyfe
𱕝	kswj
𱕟	ksaw
𱕠	kgkh
𱕢	ktgi
𱕣	kyfj
𱕤	kbww
𱕥	kctt
𱕦	kafy
𱕧	kati
𱕨	kaqr
𱕪	krlx
𱕫	kyxy
𱕬	kyad
𱕮	ksqr
𱕯	kdjo
𱕰	kyny
𱕱	kghn
𱕲	kaxl
𱕳	kukq
𱕵	kkjw
𱕶	kkaf
𱕷	kqkq
𱘖	ktkc
𱜗	ktkn
𱡩	ktfr
𱲌	kglf
𱲧	kghf
𱳻	kmhd
𱿒	kgnq
𱿕	kgnh
𲀱	kqre
𲂭	kkmu
𲂴	khgh
𲂴	khmh
𲃆	khmh
𲃔	khnn
𲃖	khcg
𲃘	khdn
𲃙	khtn
𲃚	khah
𲃛	khmg
𲃜	khqg
𲃝	khlt
𲃞	khqs
𲃟	khwc
𲃠	khye
𲃡	khpl
𲃢	khte
𲃣	khpe
𲃤	khpn
𲃥	khnu
𲃦	khlp
𲃧	khan
𲃨	khkk
𲃩	khaf
𲃪	khyf
𲃫	khgm
𲃬	khtj
𲃭	khpd
𲃮	khpa
𲃯	khuw
𲃰	khsf
𲃱	khxr
𲃲	khdc
𲃳	khkk
𲃵	khmp
𲃶	khqw
𲃷	kheg
𲃸	khwh
𲃹	khiq
𲃺	khxm
𲃽	khax
𲃾	khtn
𲃿	khye
𲄀	khop
𲄁	khho
𲄂	khtp
𲄃	khty
𲄄	khyg
𲄇	khfn
𲄈	khdo
𲄉	khpj
𲄌	khaq
𲄍	khal
𲄎	khpl
𲄏	khup
𲄐	khxi
𲄒	khdf
𲄓	khyy
𲄔	khyd
𲄕	khae
𲄖	khwq
𲆛	kcbc
𲆡	kgnn
𲇦	kgnq
𲍹	ksqg
𱏯	ltkq
𱐜	lpjh
𱐫	ldg
𱐯	lpxn
𱐰	ldqn
𱐴	lkde
𱐶	llss
𱑈	lftr
𱓃	lwgk
𱕸	lnny
𱕹	lqnv
𱕺	lji
𱕻	lqoi
𱕻	lquu
𱕻	lqyy
𱕼	ludi
𱕽	lpei
𱕿	lwwk
𱖀	lqaj
𱖁	lnhq
𱖂	lxgi
𱖃	lawn
𱖄	lrna
𱜂	lfnc
𱝤	lfce
𱡜	lgjt
𱥦	lfun
𱫤	lllo
𱬠	lolo
𱰛	lltl
𱰣	lmgy
𱰧	ltbn
𱰪	lwuu
𱰫	ldnn
𱰫	lhgq
𱰫	lyt
𱰬	lunt
𱰮	lwgb
𱰱	lguw
𱰶	lgiw
𱰹	lhic
𱰻	lgef
𱰼	llgo
𱰽	lmct
𱰾	lltf
𱰿	lfnk
𱱂	lawn
𱱄	llbm
𱲤	lhg
𱲬	lwbb
𱳬	ldf
𱺵	lanb
𱺵	lgjn
𱺷	ldnb
𱺸	lxxb
𱺹	lqjj
𱺺	lwvb
𱺻	lhpu
𱺻	lpu
𱺾	ltkq
𱻂	lbuu
𱻃	lttg
𱻅	lpeg
𱻆	lxix
𱻇	ljff
𱻤	lnhn
𱼄	lmww
𲂷	lmad
𲂹	lmyd
𲄳	ldy
𲄵	ltah
𲄶	ltdj
𲄷	lgvh
𲄸	lmcf
𲄸	lmgf
𲄹	luog
𲄼	lybc
𲄽	lumd
𲄾	lbci
𲅀	lfnh
𲅁	lqcy
𲅂	lnsy
𲅦	lfjp
𲆉	ltwp
𲆝	lkmb
𲊯	lgdm
𲌖	lymk
𲎃	lxig
𲎘	lfom
𲎙	lhnh
𱍫	mgd
𱏺	mad
𱏻	mcci
𱐐	mmgj
𱐚	mgnj
𱑥	mfcy
𱖆	mfd
𱖔	mggf
𱛆	mbj
𱛇	mgng
𱛉	mdbn
𱛊	mmqb
𱛋	mmwy
𱛌	mweb
𱛍	mwxn
𱛎	mqrr
𱛏	mtay
𱛐	mxhj
𱛑	mnwy
𱛒	mbnb
𱛓	mdxn
𱛔	mfcu
𱛕	mdmh
𱛖	mlj
𱛗	mmmg
𱛘	mrhy
𱛙	mqiy
𱛚	mtlt
𱛜	mdhf
𱛝	mgog
𱛞	mamy
𱛟	mddu
𱛠	mdoy
𱛡	mdfn
𱛢	mkkf
𱛣	miff
𱛤	mldu
𱛥	mtfq
𱛦	mytf
𱛧	mvbf
𱛨	mamy
𱛩	mgki
𱛫	mmy
𱛬	mjfu
𱛭	mefy
𱛮	mqeh
𱛯	mwkq
𱛰	mvoy
𱛱	mfuf
𱛲	mgtu
𱛳	mmdg
𱛴	mqgg
𱛵	mqrm
𱛶	mtgf
𱛷	madm
𱛸	mdwj
𱛹	mbbh
𱛺	mgki
𱛻	mamd
𱛼	mtvh
𱛽	mwdc
𱛾	myox
𱛿	miff
𱜀	mcel
𱜁	mfit
𱜃	mqbt
𱜄	mwqu
𱜅	mgmj
𱜆	mhak
𱜇	mwym
𱜈	mton
𱜉	mtdp
𱜊	mqoy
𱜋	mypn
𱜌	mpfh
𱜍	mwtl
𱜎	mqtl
𱜏	mtvh
𱜑	mtgo
𱜓	mtmm
𱜔	mwnh
𱜕	mgxu
𱜤	mhgw
𱜥	mhte
𱜩	mhwj
𱜪	mhrh
𱜬	mhyi
𱜭	mhnm
𱜯	mhra
𱜰	mhrh
𱜱	mhyd
𱜳	mhjq
𱜴	mhyc
𱜵	mhgn
𱜸	mhye
𱜺	mhfm
𱜻	mhkk
𱜼	mhud
𱝒	mapd
𱟠	mwya
𱢵	maad
𱤢	mwgi
𱭭	mqjh
𱰏	meey
𱰨	mmxb
𱰳	mdlf
𱴝	mykd
𱴫	mykd
𱴲	mvtd
𱺴	mqqa
𱺽	mqfj
𱺿	mqff
𱻀	mqlq
𱻄	mwwb
𱻈	mqqo
𱻧	mftx
𱼃	mwwu
𱼛	mwwt
𱽀	mjge
𲁒	mqrk
𲁓	mqmq
𲂨	mwxt
𲂪	msgg
𲂬	mntt
𲂮	mdiy
𲂯	mpbg
𲂰	mhjh
𲂱	mrny
𲂲	mjqn
𲂳	mtgf
𲂸	mfaw
𲂻	mmy
𲂼	mrh
𲂽	muy
𲂾	mdg
𲂿	mskg
𲃁	mufh
𲃂	myhk
𲃃	mviy
𲃅	movg
𲅑	mpi
𲅨	mgqp
𲇑	mmqf
𲋄	mfd
𲋅	mtjt
𲋆	mtjt
𲋈	mfwj
𲋉	mtjy
𲋊	mtjn
𲋋	mfwp
𲋌	mtjl
𲋍	mtjy
𲋏	mqtn
𲋐	mqdx
𲋑	mqvi
𲌌	medc
𲌍	menc
𲌎	mees
𲌏	mevi
𲌐	mewb
𲌑	meyi
𲌒	meyg
𲌓	mewp
𲌔	meot
𲌕	mesw
𲌫	muyc
𲌳	mdqo
𱎀	nvd
𱎃	niev
𱎄	nivd
𱎅	ntkd
𱎆	nqeh
𱎇	ndjd
𱎈	nshd
𱎉	nbbk
𱎋	ngvb
𱎌	ngkp
𱎍	nief
𱑑	ntfd
𱑔	nkuf
𱑛	nhdy
𱙜	nxvb
𱚛	nweq
𱚰	nfk
𱚱	nfi
𱚲	nghi
𱚳	nite
𱚴	nnfd
𱚵	nrwi
𱚶	nlkd
𱚷	nwnn
𱚸	nyei
𱚹	nyeg
𱚺	nevd
𱚻	ntti
𱚼	nseg
𱚽	nndq
𱚾	nbma
𱚿	niel
𱛀	nyun
𱛁	ntff
𱛂	ntfi
𱛃	nudd
𱝽	ncy
𱞀	nbg
𱞁	nnn
𱞅	nyly
𱞆	nfnu
𱞇	nxnn
𱞈	ngny
𱞊	nhhy
𱞋	nhnt
𱞌	nrhy
𱞏	nlkg
𱞐	nvbh
𱞑	ntpg
𱞒	ntln
𱞔	nxqy
𱞕	nffy
𱞗	ndfe
𱞘	nfwb
𱞙	nsgg
𱞚	ntxi
𱞛	ntrt
𱞞	njqb
𱞟	njfw
𱞠	njcm
𱞢	nqrm
𱞣	nwye
𱞤	nynj
𱞦	nugc
𱞧	nyqy
𱞨	nvph
𱞩	nxgi
𱞪	ndgt
𱞫	ngli
𱞬	nseg
𱞭	nalg
𱞮	njug
𱞯	njog
𱞰	nhka
𱞳	ntxn
𱞴	nqte
𱞶	nipq
𱞷	nuph
𱞸	nugd
𱞺	nxig
𱞻	nvfp
𱞽	ndkk
𱞾	nrde
𱞿	npfe
𱟀	nytr
𱟁	nwhs
𱟂	noof
𱟃	nips
𱟄	nymw
𱟆	nftf
𱟇	nfhn
𱟈	nhhh
𱟉	nate
𱟊	nkkn
𱟋	ndjy
𱟌	nipq
𱟎	nuja
𱟏	nias
𱟐	nnwr
𱟑	nnhi
𱟒	nfwo
𱟓	nton
𱟕	ntga
𱟗	nylt
𱟘	ndan
𱟚	nwyy
𱥆	ntfh
𱥨	nnny
𱥩	nnan
𱧇	ntfi
𱫞	nxfo
𱫭	nhdo
𱭍	nhdh
𱭎	nhdn
𱭏	nhdi
𱭐	nhda
𱭑	nhdp
𱭒	nhdy
𱭓	nhda
𱭔	nhdd
𱭕	ntgb
𱭖	nhdh
𱯢	ngyh
𱯳	nkgu
𱯻	nkfy
𱰄	nyuy
𱰤	nld
𱱃	nygo
𱱇	nhgq
𱱈	nhaj
𱲯	nwhd
𱻗	ngmm
𱻘	nnan
𱻚	ndgm
𱻝	ngee
𱻠	ngrf
𱽁	nhde
𱿈	nkfj
𲀏	nhjp
𲀷	nbme
𲂶	ntfm
𲄗	ntmt
𲅇	nguh
𲅉	nkuh
𲅏	nwpi
𲅥	ndpd
𲅲	ntfp
𲅳	nhdp
𲉭	nywq
𲊢	nhgx
𲊢	nhkx
𲊣	nhgh
𲊣	nhkh
𲊤	nhgp
𲊤	nhkp
𱍞	oguw
𱐍	obk
𱑺	oocu
𱘥	obwt
𱡡	ohmc
𱪡	otyy
𱪡	owy
𱪢	oln
𱪣	obn
𱪤	ogqn
𱪦	otfh
𱪧	owhh
𱪨	otfh
𱪩	ogah
𱪪	odln
𱪫	ofcy
𱪭	otdy
𱪮	oqcy
𱪯	oyly
𱪱	odag
𱪳	omg
𱪴	ohg
𱪵	ohnt
𱪹	oebg
𱪾	odfn
𱫁	ojh
𱫄	oiwy
𱫅	oyjh
𱫈	ofpm
𱫉	okhy
𱫊	oapl
𱫋	oran
𱫍	otmt
𱫎	otfo
𱫏	oydh
𱫐	ovmy
𱫑	ogey
𱫖	oamf
𱫗	oheg
𱫘	otgf
𱫛	oyhk
𱫜	oxfm
𱫣	osny
𱫦	otud
𱫨	orhg
𱫩	oipq
𱫪	oyac
𱫬	ouhb
𱫯	ogon
𱫲	odki
𱫴	olqf
𱫶	otlq
𱫷	owdh
𱫺	oyxl
𱫻	onae
𱫽	osji
𱫾	obqb
𱬀	oafl
𱬂	ohae
𱬃	ojdt
𱬅	oukg
𱬇	oqlo
𱬈	oqld
𱬉	oyyb
𱬊	oyth
𱬋	oulc
𱬌	ould
𱬍	oudn
𱬎	oyxf
𱬏	obud
𱬒	ohxi
𱬓	oaxi
𱬕	oeaj
𱬘	oieq
𱬙	otmt
𱬚	oqlx
𱬜	oyri
𱬞	osff
𱬟	ohay
𱬡	oajl
𱬢	oehh
𱬦	oalt
𱬫	oaif
𱬬	owgw
𱬭	oaoh
𱬮	offc
𱰆	ovry
𱰋	ogny
𱲢	obwl
𱸳	oue
𱸴	omyy
𱸵	olh
𱸶	oeg
𱸷	ohg
𱸸	obfn
𱸹	oqnn
𱸻	ogqj
𱸼	oatq
𱸽	olqy
𱸾	owfc
𱹀	ovg
𱹁	oyjh
𱹄	ogjh
𱹄	olh
𱹆	oitf
𱹉	ovit
𱹊	ogvv
𱹋	oagi
𱹍	oafs
𱹎	okkc
𱹏	ojtg
𱹐	oalk
𱹑	otff
𱹒	oqmd
𱹔	obcc
𱹕	olkm
𱹗	orno
𱹘	ougn
𱹚	otdp
𱹛	ojfo
𱹞	offq
𱹢	oglg
𱹤	oujn
𱹦	oape
𱹧	oyvo
𱹩	olag
𱼯	ovf
𱾪	ovaw
𱿻	ovju
𲅽	oolp
𲆅	oogp
𲆅	oolp
𲆇	ogup
𲆓	oabh
𲉬	ogwy
𲋀	ovdm
𱍝	pfqh
𱍻	pfd
𱏽	pfqc
𱏾	psgi
𱐳	pjhl
𱑮	pugc
𱓑	puvk
𱘨	pegq
𱚂	pbij
𱚃	pghu
𱚄	pbnb
𱚅	plkf
𱚆	pgix
𱚇	phwu
𱚇	pmu
𱚈	pbhf
𱚉	pjsu
𱚊	pmfk
𱚋	ptlf
𱚌	pxgi
𱚍	pktv
𱚎	pujj
𱚏	pco
𱚐	pwyc
𱚒	pfgf
𱚓	pntj
𱚔	pvnn
𱚕	pvfg
𱚖	phii
𱚗	ptgo
𱚘	pqab
𱚙	pntj
𱚚	pnhk
𱚜	ptha
𱝧	pfqf
𱝩	pfqn
𱟅	pynn
𱢽	pujg
𱤿	phf
𱥡	petn
𱵇	pyyv
𱶰	pqnw
𱶱	pqwj
𱶲	pquf
𱶳	pwuf
𱶴	pqyn
𱶵	pqxj
𱶶	pqfb
𱶷	pqfc
𱶸	pqhx
𱶹	pqlh
𱶺	pqjw
𱶻	pqqq
𱶼	pqwc
𱶽	pqfi
𱶾	pqkq
𱷀	pquj
𱷁	pqji
𱷂	pqnk
𱷃	pqan
𱷄	pqff
𱷅	pqgi
𱷆	pqfy
𱷇	pqty
𱷈	pqtf
𱷉	pqxh
𱷊	pqnc
𱷋	pwaq
𱷌	pqjh
𱷍	pqti
𱷎	pqbf
𱷏	pqbt
𱷐	pqfi
𱷑	pqti
𱷒	pqww
𱷓	pqry
𱷔	pqwc
𱷕	pquh
𱷖	pqty
𱷗	pqgy
𱷘	pqnc
𱷙	pqrw
𱷚	pqnu
𱷛	pqoy
𱷜	pqhi
𱷝	pqoc
𱷞	pqoc
𱷟	pqdk
𱷠	pqoc
𱷡	pqoy
𱷢	pqty
𱺼	pqfj
𱻁	pqqq
𱻙	pfqn
𲀤	push
𲀦	puft
𲀨	pugg
𲀩	pulg
𲀪	puhy
𲀫	putw
𲀬	puwa
𲀮	pung
𲀲	pukc
𲀳	puth
𲀴	puff
𲀵	pumw
𲀸	purf
𲀹	puty
𲀺	puyd
𲀻	pudi
𲀼	pugo
𲀽	puaq
𲀾	puev
𲀿	puft
𲁀	puwi
𲁁	puyp
𲁂	puys
𲁄	putn
𲁆	puvh
𲁇	puac
𲁈	puww
𲁎	pfhq
𲂙	pdck
𲂛	pwwk
𲂜	pgkk
𲄺	pgjt
𲄺	plct
𲅢	pqsp
𲅣	pmpd
𲅤	pqfp
𲈥	pety
𲊮	ptam
𲊮	ptaw
𲍤	pjuo
𲍺	pdcg
𱍣	qtgc
𱍸	qyi
𱐣	qdjj
𱐲	qvhl
𱐸	qnwh
𱐹	qrwc
𱐺	qrfi
𱐻	qnte
𱐼	qrle
𱐿	qrec
𱑀	qrfm
𱑁	qtgo
𱑂	qrfm
𱑃	qnwj
𱑚	qytj
𱑹	qaqc
𱒋	qqkf
𱒍	qdf
𱓎	qkuk
𱕩	qegx
𱖗	qhff
𱖚	qiff
𱘦	qvt
𱜒	qehm
𱜨	qidh
𱞲	qqun
𱞵	qhng
𱟖	qvnk
𱟙	qvnx
𱢳	qajj
𱤃	qsms
𱤅	qsjr
𱪶	qogg
𱪸	qbto
𱫌	qlou
𱫙	qoou
𱫧	qudo
𱬥	qhkf
𱭳	qtxx
𱭴	qtfc
𱭵	qtgy
𱭶	qthh
𱭷	qttl
𱭸	qthn
𱭹	qtqb
𱭺	qtyw
𱭻	qttw
𱭼	qtkf
𱭽	qtkt
𱭾	qtaf
𱮀	qtfd
𱮂	qtmm
𱮃	qtwq
𱮄	qtee
𱮅	qtmk
𱮆	qtgv
𱮆	qtpv
𱮇	qtcj
𱮈	qtkk
𱮉	qtsa
𱮊	qtgl
𱮋	qtjl
𱮌	qttf
𱮍	qtvw
𱮎	qtul
𱮏	qtid
𱮐	qtvn
𱮑	qtna
𱮒	qtas
𱮓	qtah
𱮔	qtah
𱮕	qtwk
𱮖	qtql
𱮗	qtue
𱮘	qtcy
𱮙	qtya
𱮚	qtle
𱮛	qttp
𱮜	qtwm
𱮝	qtyi
𱮞	qtnl
𱮟	qtul
𱮠	qtwy
𱮢	qtej
𱮣	qtwp
𱮥	qtdw
𱮦	qtlu
𱮧	qtow
𱮨	qtmq
𱮬	qtan
𱮭	qtaq
𱮮	qtft
𱮮	qtfy
𱮯	qytd
𱮰	qtuy
𱮱	qtje
𱰉	qdcy
𱰴	qykl
𱲏	qglf
𱲕	qonl
𱲖	qonl
𱳲	qbdf
𱸿	qino
𱹇	qyoo
𱹾	qygi
𱺌	qygi
𱼀	qtny
𱼀	qui
𱽉	qcoi
𱽊	qcyj
𱿾	qgju
𲀔	qkej
𲀗	qtbl
𲁚	qehk
𲁛	qehk
𲁞	qehs
𲁠	qehj
𲁠	qmfj
𲁨	qqyf
𲁯	qqdy
𲂢	qjeo
𲂵	qdbm
𲅃	qqql
𲅸	qyvp
𲆏	qgbh
𲆾	qyvg
𲇁	qijf
𲇅	qayy
𲇇	qtfn
𲇈	qcfy
𲇉	qnuy
𲇊	qsg
𲇋	qdmj
𲇌	qrta
𲇎	qgah
𲇏	qujg
𲇐	qgmj
𲇒	qafh
𲇓	qyox
𲇕	qjtl
𲇗	qain
𲇘	qavn
𲇙	qthd
𲇚	qqmx
𲇛	qugn
𲇜	qitu
𲇝	qltk
𲇞	qlwb
𲇟	qpnm
𲇠	qytf
𲇡	qhxi
𲇢	qkkt
𲇣	qaqo
𲇤	qjbc
𲇥	qayf
𲇧	qhac
𲇨	qdws
𲇪	qptk
𲇫	qbuf
𲇬	qjfc
𲇭	qftt
𲇮	qgng
𲇯	qmh
𲇰	qvtt
𲇱	qfcy
𲇲	qfny
𲇳	qqbh
𲇴	qny
𲇵	qccy
𲇶	qvtt
𲇷	qaiy
𲇸	qnan
𲇹	qgqj
𲇺	qagg
𲇻	qdhb
𲇼	qdmj
𲇽	qfny
𲇾	qgmw
𲇿	qrgw
𲈀	qwgi
𲈁	qfwf
𲈂	qgip
𲈃	qakg
𲈄	qgmy
𲈅	qkhn
𲈆	qimk
𲈇	qwqr
𲈈	qqoy
𲈉	qpgy
𲈊	qviy
𲈋	qdeg
𲈌	qdff
𲈍	qbbh
𲈎	qpgg
𲈏	qyps
𲈐	qody
𲈑	qcel
𲈒	qjiq
𲈓	qaws
𲈔	qrqc
𲈕	qfjn
𲈖	qdha
𲈗	qujh
𲈘	qugl
𲈙	qsoy
𲈚	qjyi
𲈛	qujf
𲈜	qulj
𲈝	qkhk
𲈞	qkks
𲈟	qhal
𲈠	qyny
𲈡	qaky
𲊬	qndm
𲋢	qnyy
𲋣	qnty
𲋤	qnvk
𲋥	qnpe
𲋦	qnal
𲋧	qnik
𲋨	qnxr
𲋩	qngi
𲋪	qnjl
𲋫	qnul
𲋬	qnyn
𲌱	qogn
𲌲	qouy
𲌴	qogf
𲌷	qoll
𲌸	qoqm
𲌹	qoqe
𲌺	qovd
𲌻	qodc
𲌼	qonf
𲌽	qofa
𲌾	qohe
𲌿	qotn
𲍀	qotk
𲍁	qoup
𲍃	qoua
𲍃	qout
𲍄	qomh
𲍅	qdkd
𲍆	qgnn
𲍇	qgyq
𲍈	qgyn
𲍊	qgrh
𲍋	qguy
𲍌	qgdg
𲍎	qgaw
𲍏	qgtq
𲍐	qgoy
𲍑	qgaq
𲍒	qgdt
𲍓	qggd
𲍔	qgit
𲍕	qgrf
𲍖	qgjg
𲍗	qgec
𲍘	qgfn
𲍙	qgnt
𲍬	qync
𲍯	qyng
𲍰	qiqg
𲎆	qynf
𲎈	qyne
𲎮	qjnf
𱏧	riqb
𱑻	rckk
𱕎	rgkv
𱗄	rrff
𱘻	rxad
𱚑	rhfg
𱚞	rfu
𱛛	rgmh
𱜐	rytm
𱝂	rhfc
𱝑	rhpi
𱞡	rqyn
𱟢	rnyq
𱟣	rnmt
𱟥	rnux
𱟩	rgng
𱟪	riy
𱟫	ret
𱟬	rnug
𱟭	rgoy
𱟮	rjnn
𱟯	rjmh
𱟰	rnhc
𱟱	rlg
𱟲	rtdn
𱟳	rtdn
𱟴	rpty
𱟵	rcrh
𱟶	rdng
𱟸	rhmy
𱟹	rgty
𱟺	rkrh
𱟻	rkhy
𱟼	rmgn
𱟽	rkmw
𱟾	rtet
𱟿	rqyb
𱠀	rrkh
𱠁	renn
𱠂	rwiy
𱠃	ruwb
𱠄	rpqf
𱠅	ryg
𱠆	ryfh
𱠇	rsty
𱠈	rsgi
𱠉	rgkh
𱠊	rltu
𱠌	rlqy
𱠍	ramf
𱠎	rjfw
𱠏	rpqq
𱠐	rwwa
𱠑	rwgn
𱠒	rrny
𱠓	ryty
𱠔	rwfb
𱠕	rdmv
𱠖	rdjt
𱠗	rdcc
𱠘	rsgq
𱠙	rlxx
𱠚	rjog
𱠛	rtkh
𱠜	rypq
𱠝	rugd
𱠞	rujg
𱠟	rxjb
𱠠	rdmn
𱠡	rmdl
𱠢	rthn
𱠣	rqsh
𱠥	rwgp
𱠦	ryoo
𱠧	ryos
𱠨	rpie
𱠩	rfuk
𱠪	rjgx
𱠫	rtkk
𱠬	rtsg
𱠭	rtug
𱠮	rtlt
𱠯	rbqm
𱠰	rxkn
𱠱	rfam
𱠲	rfgf
𱠳	rjff
𱠴	rity
𱠵	rqkp
𱠶	rpne
𱠷	rywy
𱠸	rxxe
𱠹	rmmn
𱠺	radn
𱠻	rjfe
𱠼	ryyw
𱠽	rcbm
𱠾	rdar
𱠿	raiy
𱡀	ryli
𱡁	rujk
𱡂	rxhj
𱡃	rnkv
𱡄	rddj
𱡅	rlff
𱡆	rhan
𱡇	rrhd
𱡈	russ
𱡉	rptl
𱡊	rxkf
𱡋	rntt
𱡌	rdtj
𱡍	ryxf
𱡎	rtlt
𱡏	rahr
𱡐	rufl
𱡑	ryak
𱡒	rkhd
𱡓	rcdd
𱡔	rywg
𱡕	rumo
𱡖	rxys
𱡪	rxrh
𱢬	rlgj
𱤴	ripl
𱥘	rrqc
𱥪	rnqh
𱥫	rnuk
𱥭	rnoe
𱫰	rnko
𱬐	rwso
𱬶	rhyb
𱬸	rhyn
𱬺	rhyy
𱬿	rhyq
𱭀	rhyr
𱭁	rhyf
𱭅	rhyl
𱰌	rrgy
𱰵	rvlf
𱱺	rhy
𱱻	rcyy
𱱼	rupy
𱱽	rgve
𱱾	rwut
𱳆	rqch
𱳈	rhfb
𱺱	rmfc
𱺲	rmug
𱺳	rmjv
𱼘	rnec
𱼵	rlgs
𲂩	rnmi
𲅔	rryp
𲅩	rgdp
𲆜	rlgc
𲌨	rqcd
𲌯	rrqi
𲌯	rtli
𲍥	rgto
𲎖	rnao
𱍒	smdy
𱐥	swwj
𱘯	skdy
𱞼	stkn
𱟷	srj
𱢾	san
𱢿	snuy
𱣁	sgqy
𱣂	sqng
𱣃	smfg
𱣄	syly
𱣆	sdf
𱣇	sogg
𱣈	smhc
𱣉	swwg
𱣊	sqtb
𱣋	scbh
𱣌	sebg
𱣏	saqy
𱣐	smjh
𱣑	smww
𱣓	srgt
𱣔	stnh
𱣕	swhg
𱣖	siwy
𱣗	syoy
𱣘	scat
𱣙	sfhy
𱣚	samy
𱣛	sffn
𱣜	srdb
𱣝	skcn
𱣞	skmy
𱣠	swng
𱣡	susy
𱣢	spdc
𱣣	syns
𱣤	sujg
𱣥	sdfa
𱣧	sffh
𱣨	ssmf
𱣩	samf
𱣪	sacn
𱣫	swwa
𱣭	sysy
𱣮	siqn
𱣯	spmg
𱣰	sifc
𱣱	sxfm
𱣲	sbsk
𱣳	svcx
𱣴	sgqg
𱣵	sbkg
𱣶	slqo
𱣶	slqu
𱣶	slqy
𱣷	skjy
𱣸	sahn
𱣹	stwj
𱣺	spqh
𱣻	slkm
𱣼	scbn
𱣽	sgqo
𱣾	sgkf
𱣿	satk
𱤀	sadi
𱤁	saqc
𱤂	sauw
𱤄	swdk
𱤆	swuk
𱤇	siiv
𱤈	ssqy
𱤋	sjdt
𱤌	smee
𱤍	swgl
𱤎	sxtu
𱤏	ssss
𱤐	sfkt
𱤐	sfky
𱤓	sdhq
𱤔	sacc
𱤕	sada
𱤖	svdt
𱤗	stkw
𱤘	stle
𱤙	sooo
𱤚	sugi
𱤛	sxuh
𱤝	shqo
𱤞	shak
𱤟	sajn
𱤠	skdn
𱤡	skhf
𱤣	swgm
𱤣	swgw
𱤤	siem
𱤥	snup
𱤨	sttp
𱤩	sthj
𱤪	stle
𱤫	snkv
𱤬	sahm
𱤬	sahw
𱤭	sdns
𱤮	sfwo
𱤯	skkk
𱤰	stfn
𱤱	skkk
𱤲	stem
𱤲	stew
𱤳	sagg
𱤵	swgd
𱤶	swfo
𱥇	sdnh
𱦆	sii
𱫔	sfou
𱬑	sgto
𱬗	sfmo
𱬤	srho
𱯑	ssgy
𱱁	swwl
𱲠	sghl
𱹥	sohc
𱼿	sjte
𱿨	ssju
𲁉	stff
𲁊	sfvy
𲁋	sffq
𲁌	sube
𲁍	stmt
𲃻	skhe
𲆀	smpi
𲆥	sggm
𲆦	sgqy
𲆧	sgnu
𲆨	sgtf
𲆩	sgwc
𲆪	sgwk
𲆫	sgqj
𲆬	sgvv
𲆭	sgdf
𲆰	sgjr
𲆱	sgee
𲆲	sgas
𲆳	sgkk
𲆴	sgel
𲆵	sgdf
𲆶	sgqt
𲆷	sgtl
𲆸	sgwk
𲆹	sgyl
𲆺	sgaf
𲆻	sgun
𲆼	sglj
𲆽	sgay
𲊻	skdm
𲍟	sbwo
𲍷	sbqg
𱍘	tfcr
𱍺	tdnb
𱎊	tonb
𱏱	tyub
𱏲	tykc
𱐩	tlb
𱑒	tfqj
𱑽	thlc
𱕏	txgk
𱗕	toff
𱗼	tgaa
𱘣	twgb
𱜫	tymh
𱜷	temh
𱝪	tyi
𱝫	thg
𱝬	tmyy
𱝭	tgmh
𱝮	ttln
𱝯	trey
𱝰	tgmw
𱝱	trmj
𱝲	trnd
𱝳	tcde
𱝴	tdeg
𱝵	tkkk
𱝶	tmff
𱝷	twgk
𱝷	twyk
𱝸	tfft
𱝹	thae
𱝺	twnh
𱝻	tadc
𱝾	tanu
𱞜	tlan
𱟔	tgjn
𱟦	tdhy
𱡭	thdr
𱣒	tfhs
𱥊	tnhh
𱥜	tfqu
𱥞	tfnw
𱥟	tfnt
𱥢	tfnj
𱥣	tfnk
𱥤	tfnn
𱥧	tfne
𱥮	tgii
𱫚	tgvo
𱫵	tloo
𱬆	tlto
𱬴	tou
𱭙	thgu
𱭚	thgp
𱭛	thgv
𱭜	thgm
𱭝	thgc
𱭞	thge
𱭟	thgk
𱭠	thgj
𱭡	thgw
𱭩	tryy
𱭪	trah
𱭫	treh
𱭬	trrg
𱭮	trye
𱭯	tqtc
𱭰	trak
𱭱	trxh
𱭲	trim
𱰈	tggy
𱰗	tgqx
𱰘	tgll
𱰚	tgbl
𱰩	tflf
𱱀	tolg
𱲟	tael
𱲨	tliu
𱲻	tlqu
𱳝	tddj
𱳞	tduw
𱳟	tdgj
𱳠	tdhn
𱳡	tdkr
𱳢	tddd
𱳣	tdsk
𱳤	tdkn
𱳥	tdro
𱳦	tdis
𱳧	tdmp
𱴛	todf
𱵀	tryd
𱵊	tini
𱵋	tlfi
𱵼	tqyy
𱵽	ttkg
𱵾	trng
𱵿	tdkg
𱶀	ttpy
𱶁	tryy
𱶂	tddy
𱶃	tkqy
𱶄	tlbn
𱶅	tqcn
𱶆	tdiy
𱶈	tfmh
𱶊	tycq
𱶋	tvgj
𱶌	tgmy
𱶍	tgij
𱶎	thaq
𱶏	tktg
𱶐	tapl
𱶑	tqvg
𱶒	twnf
𱶓	tdnh
𱶔	tdgj
𱶕	tsge
𱶖	tldc
𱶗	tpde
𱶘	tayy
𱶘	tyay
𱶙	tymh
𱶚	tukn
𱶛	tgwk
𱶜	tthd
𱶝	ttmh
𱶞	ttvb
𱶠	tpdk
𱶤	tumy
𱶦	taas
𱶧	tmdt
𱶩	tmlv
𱶪	toqn
𱶬	tlcg
𱶭	taal
𱶮	tvhq
𱶯	texo
𱷫	tdfu
𱷮	twu
𱷯	tftr
𱷰	tdlr
𱷱	tfbj
𱷱	tgmj
𱷲	tfcu
𱷳	tjf
𱷴	trhj
𱷵	tknh
𱷶	taww
𱷷	trvy
𱷸	tmjj
𱷹	tkmh
𱷺	twfw
𱷼	tvmh
𱷽	tvfu
𱷾	trbc
𱷿	tsdy
𱸀	tgvv
𱸁	tfcb
𱸂	tsaq
𱸃	tajf
𱸄	treg
𱸅	tfhc
𱸆	tfyx
𱸇	tapl
𱸈	thxf
𱸉	tyiq
𱸊	timf
𱸋	tblf
𱸌	tbwf
𱸍	tsvf
𱸎	tffy
𱸏	tsgb
𱸐	tgdt
𱸑	tdjf
𱸒	tthn
𱸓	tgpg
𱸔	txyq
𱸕	tccf
𱸖	tsud
𱸗	tbcc
𱸘	tydj
𱸙	tigi
𱸚	touf
𱸛	tcdl
𱸜	tssf
𱸝	tfuk
𱸞	trdd
𱸟	tsnn
𱸠	twle
𱸡	typn
𱸢	tuiq
𱸣	tvtl
𱸤	txkn
𱸥	tteq
𱸦	teaj
𱸧	tqgj
𱸨	txcj
𱸩	tygh
𱸪	tngf
𱸫	tfjs
𱸬	trad
𱸭	tirc
𱸮	tnhd
𱸯	tfff
𱸰	tftq
𱸱	ttei
𱸲	txhw
𱹬	tdxi
𱻋	tfnd
𱻶	tfik
𱼧	tahh
𱼨	thvn
𱼳	tdwk
𱼴	tdfh
𱼴	tdfl
𱼶	tenn
𱼷	tehg
𱼸	temq
𱼹	tegw
𱼺	tewf
𱼻	tecc
𱼼	teff
𱼽	tejq
𱼾	teww
𱽂	teaf
𱽃	tegj
𱽄	teny
𱽅	tekt
𱽆	texa
𱾷	tlqt
𱿦	txgu
𲀑	tmqj
𲀘	tlqe
𲀙	tlas
𲀚	tleq
𲀛	tmhh
𲀜	txfh
𲀝	tlfh
𲀞	tych
𲀟	tfnh
𲀠	tqrh
𲀡	tfch
𲀢	tech
𲀣	tuth
𲁮	tify
𲄘	tmdg
𲄙	tmdl
𲄚	tmdy
𲄛	tmdc
𲄜	tmdr
𲄞	tmdo
𲄟	tmdw
𲄠	tmdo
𲄡	tmdc
𲄢	tmdl
𲄣	tmdi
𲄤	tmdg
𲄥	tmdm
𲄦	tmdy
𲄧	tmdv
𲄨	tmdp
𲄩	tmdf
𲄪	tmdq
𲄫	tmde
𲄬	tmdi
𲄭	tmdp
𲄮	tmdm
𲄯	tmdt
𲄰	tmdw
𲄱	tmdk
𲄲	tmdo
𲄿	tujf
𲄿	tujl
𲅈	thud
𲅕	tghp
𲅘	thpd
𲅪	tffp
𲅰	tjgp
𲅷	tffp
𲅹	tolp
𲅺	tvmp
𲅼	tjtp
𲆂	tdrp
𲆃	toop
𲆄	tdkp
𲆌	tfqp
𲆍	tlep
𲇀	tonn
𲇄	tgje
𲈤	tayc
𲊨	tdkj
𲋮	tjgi
𲋯	tjag
𲋰	tjgi
𲋱	tjwl
𲋲	tjac
𲋾	tqyc
𲌧	tlqi
𲌩	tlqm
𲌪	tlqd
𲌬	tlqd
𲌭	tlqf
𲌮	tlqi
𲌰	tlqq
𲍱	thfg
𲎡	thlr
𱍖	ufgh
𱏫	urxq
𱏬	uekq
𱏳	uhy
𱏴	uawu
𱏿	ukg
𱐀	umy
𱐁	uhbh
𱐂	uqhy
𱐃	uiqy
𱐄	ukmy
𱐅	umy
𱐆	urhk
𱐇	udmy
𱐈	ugdj
𱐉	uwdr
𱐊	uujn
𱐋	ugho
𱐌	ufkk
𱐙	udjh
𱐡	ugtv
𱐨	uejk
𱐪	ule
𱗈	uaff
𱚭	upmy
𱜢	umhj
𱜣	umhw
𱝀	uauo
𱝕	ucaj
𱝗	ueka
𱞎	ucnu
𱞹	unqq
𱟍	ugkn
𱟡	uega
𱤺	uqww
𱥅	uthh
𱫫	ucgo
𱬛	uhut
𱬛	uhuy
𱭗	uqoy
𱭘	uudh
𱮁	uhdy
𱰍	uhky
𱰯	uklf
𱱉	udnv
𱱊	uuv
𱱋	utfd
𱱌	uti
𱱍	uuxv
𱱎	ukqv
𱱏	uufk
𱱐	uud
𱱑	uxve
𱱒	urhb
𱱓	utkd
𱱔	upgf
𱱕	umft
𱱖	uwsk
𱱗	utgh
𱱘	udmf
𱱙	ugkb
𱱚	uhab
𱱛	upah
𱱜	uwff
𱱝	uayq
𱱞	ujtl
𱱟	uqey
𱱠	uqbt
𱱡	uhak
𱱢	uceq
𱱣	uigh
𱱤	uybt
𱱥	uoqh
𱱦	ucei
𱱧	ufwo
𱱨	ujeq
𱱩	uqgt
𱱪	uvuo
𱱫	ugki
𱱬	uvgt
𱱭	ujer
𱱮	ukqi
𱱯	uxej
𱱰	uwga
𱱱	uubh
𱱲	ufll
𱱲	ugpl
𱱳	uqft
𱱳	uqfy
𱲜	uglw
𱳓	uajh
𱵯	uthi
𱷤	uquf
𱷥	uiqu
𱷦	ucdq
𱷧	ujqg
𱷨	uycb
𱷩	umph
𱷪	umfh
𱷬	uwhc
𱷭	uvhc
𱹓	ulou
𱻊	ugcu
𱻌	ugeu
𱻍	udwy
𱻎	ugqi
𱻏	ugdg
𱻐	ugdn
𱻒	uglq
𱻓	ueuf
𱻔	ugdg
𱻢	ujnn
𱼟	uxeh
𱼠	uxey
𱾣	uajy
𱾦	uxas
𲀇	ukbj
𲁗	usmq
𲁘	ujmq
𲁙	upyq
𲅄	utt
𲅅	ufjg
𲅅	ugjg
𲅆	unrr
𲅫	uqrp
𲅱	uvfp
𲅾	uthi
𲅿	ujfp
𲆊	ujjp
𲈧	uee
𲈨	uld
𲈩	uqve
𲈪	uxxv
𲈫	uyfh
𲈬	urnr
𲈭	uxgi
𲈮	urgd
𲈯	uake
𲈰	uyxl
𲈱	ugjp
𲈱	ulyp
𲈲	ufag
𲈳	ujfh
𲈵	uii
𲈶	umqv
𲈷	ucci
𲈸	unfd
𲈹	usd
𲈺	uiqv
𲈻	uwtf
𲈼	urii
𲈽	ugkd
𲉀	upuv
𲉁	uawn
𲉂	ufff
𲉃	uadk
𲉄	umgu
𲉅	uyvk
𲉆	uajd
𲉇	ugda
𲊚	ugvd
𲊝	ukfw
𲊧	ujtk
𲊩	ujqk
𲍧	uxxo
𲍫	uhqg
𲍻	ujqg
𲎦	uveb
𲎬	ujne
𲎭	ujng
𱍧	vakh
𱎂	vui
𱐓	vwvt
𱐔	vyvy
𱐕	vvvt
𱐖	vjgg
𱐗	vthf
𱖉	vff
𱖵	vkbf
𱘂	vdaf
𱙁	vgf
𱙂	vqn
𱙃	vbb
𱙄	vgng
𱙅	vun
𱙆	vnuy
𱙇	vwxn
𱙈	vtfh
𱙊	vfvg
𱙋	vhnt
𱙌	vlg
𱙍	vcfg
𱙏	vlvg
𱙐	vvg
𱙑	vyjh
𱙒	vubg
𱙓	vpgf
𱙔	vgod
𱙕	vjfg
𱙖	vwwk
𱙗	vueg
𱙙	vvoy
𱙚	vvwy
𱙛	vybg
𱙝	vkbg
𱙞	vhag
𱙟	vugj
𱙠	vgef
𱙡	vade
𱙢	vrev
𱙣	vmth
𱙤	vaws
𱙥	vyon
𱙦	vcex
𱙧	vhag
𱙨	vaqe
𱙩	vtlt
𱙪	vpdk
𱙫	vpgw
𱙬	vcff
𱙭	vdwy
𱙮	vaes
𱙯	vday
𱙰	vype
𱙱	vbxh
𱙴	vakw
𱜖	vjss
𱝟	vigf
𱝠	vqmh
𱞖	vfnu
𱟜	vpma
𱪰	vvou
𱫝	vmgo
𱫟	votg
𱫮	vhgo
𱬧	vtlo
𱬰	vepo
𱬲	vmgo
𱰇	vtly
𱰭	vglf
𱲛	volf
𱸺	vcou
𱻖	vtkd
𱼊	vlef
𱼭	vff
𱼮	vfgq
𱼰	vmft
𱼱	vgnf
𲀋	vjjy
𲂺	vmu
𲄻	vlgk
𲆔	vobh
𲆠	vfbd
𲉧	vwyg
𲉪	vkwy
𲊲	vqdm
𲋖	vcwe
𲍲	vkqg
𲎇	vnug
𲎝	vnut
𲎞	vnuk
𲎟	vnus
𲎠	vnuv
𱍜	wwkh
𱍼	whqg
𱎏	wmib
𱎚	wre
𱎛	wff
𱎜	wghu
𱎝	wynn
𱎞	wbgg
𱎟	wnrt
𱎡	wmy
𱎢	whbh
𱎣	wwwi
𱎤	wmfg
𱎥	wrj
𱎦	whfh
𱎧	wbnn
𱎨	wwag
𱎩	wtdn
𱎪	wcfh
𱎫	wgog
𱎬	wrmh
𱎭	wvbg
𱎮	wgjg
𱎯	wkmy
𱎰	wjfg
𱎱	wynn
𱎲	wbhc
𱎳	wheg
𱎴	wmun
𱎵	wjtf
𱎶	wmai
𱎸	wqbp
𱎹	wugc
𱎺	wblg
𱎻	wtcb
𱎼	wafh
𱎽	wriy
𱎾	wudc
𱎿	wgoj
𱏀	wgon
𱏁	wawc
𱏂	wugj
𱏃	wgve
𱏄	wpdk
𱏅	wfkg
𱏆	wmmv
𱏇	wksq
𱏈	wtsg
𱏉	wwav
𱏊	wydg
𱏋	wydn
𱏌	waqj
𱏍	wdem
𱏐	wipm
𱏑	whxi
𱏒	wqqw
𱏓	wugi
𱏔	wgkm
𱏕	wtve
𱏖	wvll
𱏗	wgvc
𱏘	wksh
𱏘	wksl
𱏙	wksi
𱏚	wqan
𱏛	wksm
𱏜	wqmq
𱏝	wqas
𱏞	whwm
𱏟	wksm
𱏠	wogh
𱏡	wtrm
𱏢	wwwn
𱏣	wxyj
𱏸	wcuj
𱐏	wfub
𱐢	wfij
𱐧	wgkk
𱑴	wnnc
𱑷	wtcu
𱒱	wtkf
𱔋	wgkd
𱔐	wnkk
𱖋	wxff
𱖌	weff
𱖦	wwwf
𱗁	wkqf
𱗣	wcnf
𱗾	wwfh
𱘧	wtqq
𱘳	whfd
𱙉	wevf
𱚝	wvfu
𱜘	wgmn
𱜜	wdun
𱝘	wvoa
𱝛	wcxb
𱞃	wxnu
𱞱	woan
𱡠	wykt
𱡬	wqrh
𱢷	wglf
𱢸	wgbe
𱥯	wiu
𱥷	wviu
𱦕	wgki
𱩫	wfmi
𱪷	wfno
𱬔	wfjo
𱬱	wnno
𱬳	wyoo
𱭊	wqgy
𱭋	wfiq
𱰊	wgky
𱰓	wgky
𱰖	wgkf
𱱴	wsj
𱱵	wkgf
𱱶	wrcu
𱱷	wxyu
𱱸	wxtu
𱵫	wgki
𱵹	wycc
𱵺	whbc
𱵻	wwwy
𱶉	wvgt
𱹭	wqxi
𱺄	wkqi
𱻑	wgku
𱻱	wngj
𱽈	wfve
𱿁	wgkd
𱿥	wqij
𲀥	wyeu
𲁏	wfwq
𲂘	wgnk
𲃄	wksm
𲄻	wflk
𲅍	wneh
𲅒	wxpy
𲅛	wupd
𲅡	wwgp
𲅬	wgkp
𲅯	wkfp
𲆕	wakb
𲆿	wsgg
𲇆	whfu
𲈣	wdju
𲉐	wnni
𲉔	wnne
𲉙	wnnh
𲉩	wycc
𲉫	wyct
𲊶	wgvm
𲊽	wvfm
𲋁	wynm
𲋇	wgef
𲋔	wgvf
𲋕	wgvt
𲋘	wgvq
𲋙	wyvf
𲋚	wyva
𲋜	wgvr
𲋝	wyvw
𲋞	wgvh
𲋟	wgva
𲋠	wgve
𲋡	wgvi
𲍚	wvgf
𲍜	wvgc
𲍝	wvgw
𲍠	wvgb
𲍡	wvgp
𲍢	wvgf
𲍦	wvgm
𲍩	wvgl
𲍶	wdqg
𲍾	wyqg
𲎂	wycg
𱑄	xvmh
𱑅	xtdt
𱕾	xxlk
𱘚	xxgf
𱘿	xigd
𱘿	xild
𱝙	xkhh
𱝚	xwcy
𱝜	xhnt
𱝝	xjfg
𱝞	xlgy
𱝡	xgxy
𱞄	xxnu
𱤹	xrxw
𱪼	xjou
𱹪	xitt
𱹫	xihn
𱹮	xway
𱹯	xifi
𱹰	xirk
𱹱	xifn
𱹲	xidb
𱹳	xvfy
𱹴	xgoy
𱹵	xuny
𱹶	xfjg
𱹷	xamw
𱹸	xiqh
𱹹	xiwa
𱹺	xigm
𱹻	xdcc
𱹼	xvgl
𱹿	xigr
𱹿	xilr
𱺀	xiaf
𱺁	xidk
𱺂	xijq
𱺃	xiif
𱺅	xqax
𱺆	xitj
𱺇	xtli
𱺈	xyvk
𱺉	xigl
𱺊	xigm
𱺍	xigi
𱺎	xuju
𱺏	xhy
𱺐	xtyy
𱺑	xbh
𱺒	xmhh
𱺓	xrh
𱺔	xdmh
𱺕	xdxy
𱺖	xpsh
𱺗	xasj
𱺘	xnan
𱺙	xnxn
𱺚	xrkg
𱺛	xdiy
𱺜	xgoy
𱺝	xfoy
𱺞	xtfk
𱺟	xqym
𱺠	xwtf
𱺡	xyve
𱺢	xvfb
𱺣	xapl
𱺤	xhxf
𱺥	xbwf
𱺦	xdjf
𱺧	xgli
𱺨	xqkl
𱺩	xugd
𱺪	xipf
𱺫	xpnm
𱺬	xtff
𱺭	xflg
𱺮	xype
𱺯	xawi
𱺰	xgke
𲅙	xqyp
𲆆	xigp
𲆖	xgqb
𲆘	xtnb
𲆤	xiyb
𲍴	xxfg
𱍷	ytcy
𱎐	yjqn
𱎗	ytnf
𱎘	ycbf
𱎙	ypqq
𱏥	yqaq
𱏨	yokq
𱐟	ywwj
𱐦	yssj
𱑎	yofj
𱑼	ytyc
𱒢	yokf
𱖐	yff
𱗳	ybbf
𱘁	yidf
𱘩	ywtk
𱝃	ysd
𱝄	yoci
𱝅	yaii
𱝆	ydyl
𱝇	ygkp
𱝈	yaqe
𱝉	ycen
𱝊	ydui
𱝋	yipr
𱝌	yiaw
𱝍	ybwd
𱝏	yioh
𱝿	yqnu
𱞥	yqln
𱟧	ynyp
𱡢	ymhh
𱡣	ymhj
𱡤	yfhg
𱡥	yrnr
𱡦	ynbm
𱡧	yvmo
𱡧	ywfo
𱡨	yvwf
𱡱	yitt
𱡲	ytmh
𱡳	ytkh
𱡴	yamf
𱡶	ytff
𱡷	ywlj
𱡸	ytce
𱣅	ysu
𱣬	ytsu
𱥥	ynjn
𱥬	yojn
𱪻	yayo
𱫹	yjgo
𱬩	yopo
𱬪	ybve
𱬽	ymhy
𱯁	ycqg
𱰡	yvee
𱲗	yonl
𱲙	yonl
𱲝	yonl
𱲡	yjul
𱲣	ythd
𱲼	ynnh
𱶣	yolt
𱶥	yntm
𱶨	ylkt
𱶫	ykkt
𱹂	ynio
𱹃	yoou
𱹈	yono
𱹌	ylao
𱹙	yolo
𱹜	yvio
𱹝	yolo
𱹟	yilo
𱹠	yoso
𱹡	yolo
𱹨	ykko
𱺶	ynmq
𱻕	ynlf
𱻥	ynnw
𱼥	ypeo
𱽇	ycve
𲀌	ywwj
𲀭	yyee
𲀯	yahe
𲀶	ymhe
𲁅	yxte
𲁡	yftt
𲁢	ytfh
𲁣	yynn
𲁤	yyqy
𲁥	yvtt
𲁧	ydhg
𲁩	yyfg
𲁪	ygcj
𲁫	ymgg
𲁬	yttg
𲁭	yywf
𲁰	yqku
𲁱	yxxf
𲁲	ydht
𲁳	yyke
𲁴	ygqe
𲁵	yonr
𲁶	yskf
𲁷	yjjy
𲁸	yuwf
𲁹	yxxx
𲁺	ymnp
𲁻	yfje
𲁼	yean
𲁽	yynl
𲁾	yjkj
𲁿	ywfo
𲂀	yafc
𲂁	ywyy
𲂂	ymyy
𲂃	ycyy
𲂄	yfcy
𲂅	yeyy
𲂆	ylh
𲂇	ypsh
𲂈	ydmj
𲂉	ygog
𲂊	ywxf
𲂋	ylsy
𲂌	yjcf
𲂍	yyg
𲂎	yarg
𲂏	ygey
𲂐	yfmf
𲂑	yjlg
𲂒	yjog
𲂓	ygmj
𲂔	yyao
𲂕	yyuo
𲂖	yuep
𲂗	yvln
𲄅	ywkh
𲅝	ytfp
𲅞	yxfp
𲅭	ytep
𲈾	yfhu
𲈿	yfhu
𲉯	ywyf
𲊦	ydjg
𲌗	ymkq
𲌘	yklv
𲌙	ymki
𲍂	ylko
𲍮	yqyg
𲍿	ywtg
𲎉	yssg
𲎋	ynjo
𲎌	ynji
𲎍	ynjo
𲎎	ynjw
𲎔	ysss
